winner,turns,win_rate_player_1,win_rate_player_2,cards_played_player_1,cards_played_player_2,hand_value_player_1,hand_value_player_2,score_player_1,score_player_2
Random,19,1.0,0.0,11,9,0,28,0,28
CardCounter,17,0.5,0.5,8,11,27,0,27,28
CardCounter,14,0.3333333333333333,0.6666666666666666,7,7,73,0,100,28
Random,38,0.5,0.5,23,20,0,14,100,42
Random,11,0.6,0.4,7,5,0,18,100,60
Random,34,0.6666666666666666,0.3333333333333333,17,17,0,53,100,113
CardCounter,52,0.5714285714285714,0.42857142857142855,28,29,30,0,130,113
CardCounter,59,0.5,0.5,35,31,30,0,160,113
CardCounter,16,0.4444444444444444,0.5555555555555556,8,8,10,0,170,113
CardCounter,31,0.4,0.6,16,16,7,0,177,113
Random,45,0.45454545454545453,0.5454545454545454,23,22,0,50,177,163
Random,14,0.5,0.5,7,8,0,6,177,169
Random,29,0.5384615384615384,0.46153846153846156,18,14,0,7,177,176
CardCounter,13,0.5,0.5,6,7,9,0,186,176
CardCounter,13,0.4666666666666667,0.5333333333333333,7,6,26,0,212,176
CardCounter,17,0.4375,0.5625,8,9,21,0,233,176
CardCounter,64,0.4117647058823529,0.5882352941176471,34,34,39,0,272,176
CardCounter,11,0.3888888888888889,0.6111111111111112,5,7,57,0,329,176
CardCounter,20,0.3684210526315789,0.631578947368421,11,10,31,0,360,176
Random,28,0.4,0.6,14,14,0,29,360,205
CardCounter,56,0.38095238095238093,0.6190476190476191,29,30,8,0,368,205
CardCounter,47,0.36363636363636365,0.6363636363636364,24,27,29,0,397,205
CardCounter,44,0.34782608695652173,0.6521739130434783,22,24,12,0,409,205
Random,24,0.375,0.625,12,12,0,20,409,225
Random,69,0.4,0.6,37,39,0,6,409,231
CardCounter,19,0.38461538461538464,0.6153846153846154,9,11,12,0,421,231
CardCounter,46,0.37037037037037035,0.6296296296296297,24,25,1,0,422,231
CardCounter,53,0.35714285714285715,0.6428571428571429,26,29,6,0,428,231
Random,143,0.3793103448275862,0.6206896551724138,76,73,0,58,428,289
Random,34,0.4,0.6,19,20,0,43,428,332
Random,37,0.41935483870967744,0.5806451612903226,19,19,0,21,428,353
CardCounter,15,0.40625,0.59375,10,9,18,0,446,353
CardCounter,14,0.3939393939393939,0.6060606060606061,7,7,2,0,448,353
Random,62,0.4117647058823529,0.5882352941176471,31,33,0,13,448,366
CardCounter,34,0.4,0.6,17,18,12,0,460,366
CardCounter,7,0.3888888888888889,0.6111111111111112,3,7,97,0,557,366
CardCounter,14,0.3783783783783784,0.6216216216216216,7,8,66,0,623,366
CardCounter,11,0.3684210526315789,0.631578947368421,5,7,41,0,664,366
CardCounter,24,0.358974358974359,0.6410256410256411,14,12,5,0,669,366
CardCounter,51,0.35,0.65,26,28,37,0,706,366
CardCounter,32,0.34146341463414637,0.6585365853658537,17,16,24,0,730,366
CardCounter,65,0.3333333333333333,0.6666666666666666,36,35,9,0,739,366
Random,121,0.3488372093023256,0.6511627906976745,66,63,0,20,739,386
Random,14,0.36363636363636365,0.6363636363636364,7,7,0,54,739,440
Random,17,0.37777777777777777,0.6222222222222222,9,11,0,37,739,477
CardCounter,43,0.3695652173913043,0.6304347826086957,22,24,25,0,764,477
CardCounter,38,0.3617021276595745,0.6382978723404256,24,20,32,0,796,477
CardCounter,37,0.3541666666666667,0.6458333333333334,19,21,24,0,820,477
CardCounter,8,0.3469387755102041,0.6530612244897959,5,6,39,0,859,477
Random,32,0.36,0.64,17,18,0,140,859,617
CardCounter,20,0.35294117647058826,0.6470588235294118,10,10,32,0,891,617
Random,26,0.36538461538461536,0.6346153846153846,15,14,0,24,891,641
Random,9,0.37735849056603776,0.6226415094339622,7,4,0,90,891,731
Random,78,0.3888888888888889,0.6111111111111112,41,39,0,50,891,781
CardCounter,36,0.38181818181818183,0.6181818181818182,19,18,33,0,924,781
Random,36,0.39285714285714285,0.6071428571428571,21,20,0,6,924,787
Random,13,0.40350877192982454,0.5964912280701754,7,6,0,30,924,817
CardCounter,39,0.39655172413793105,0.603448275862069,19,22,27,0,951,817
Random,79,0.4067796610169492,0.5932203389830508,43,42,0,21,951,838
Random,154,0.4166666666666667,0.5833333333333334,82,83,0,24,951,862
CardCounter,38,0.4098360655737705,0.5901639344262295,20,20,38,0,989,862
CardCounter,37,0.4032258064516129,0.5967741935483871,21,21,25,0,1014,862
Random,29,0.4126984126984127,0.5873015873015873,17,15,0,53,1014,915
Random,34,0.421875,0.578125,20,18,0,58,1014,973
Random,49,0.4307692307692308,0.5692307692307692,27,25,0,12,1014,985
CardCounter,15,0.42424242424242425,0.5757575757575758,7,9,76,0,1090,985
Random,13,0.43283582089552236,0.5671641791044776,7,8,0,21,1090,1006
Random,18,0.4411764705882353,0.5588235294117647,9,9,0,102,1090,1108
CardCounter,30,0.43478260869565216,0.5652173913043478,16,15,113,0,1203,1108
Random,82,0.44285714285714284,0.5571428571428572,44,42,0,4,1203,1112
CardCounter,28,0.43661971830985913,0.5633802816901409,16,15,28,0,1231,1112
Random,18,0.4444444444444444,0.5555555555555556,9,10,0,20,1231,1132
Random,15,0.4520547945205479,0.547945205479452,8,8,0,46,1231,1178
CardCounter,45,0.44594594594594594,0.5540540540540541,22,26,20,0,1251,1178
CardCounter,16,0.44,0.56,9,8,8,0,1259,1178
CardCounter,13,0.4342105263157895,0.5657894736842105,6,7,24,0,1283,1178
Random,35,0.44155844155844154,0.5584415584415584,18,20,0,63,1283,1241
CardCounter,39,0.4358974358974359,0.5641025641025641,19,20,22,0,1305,1241
CardCounter,86,0.43037974683544306,0.569620253164557,45,46,68,0,1373,1241
CardCounter,145,0.425,0.575,76,78,21,0,1394,1241
Random,23,0.43209876543209874,0.5679012345679012,14,12,0,14,1394,1255
CardCounter,45,0.4268292682926829,0.573170731707317,24,24,9,0,1403,1255
CardCounter,46,0.42168674698795183,0.5783132530120482,27,23,20,0,1423,1255
Random,26,0.42857142857142855,0.5714285714285714,13,13,0,34,1423,1289
CardCounter,16,0.4235294117647059,0.5764705882352941,9,9,48,0,1471,1289
CardCounter,21,0.4186046511627907,0.5813953488372093,11,12,71,0,1542,1289
Random,15,0.42528735632183906,0.5747126436781609,8,7,0,121,1542,1410
CardCounter,65,0.42045454545454547,0.5795454545454546,33,35,27,0,1569,1410
CardCounter,64,0.4157303370786517,0.5842696629213483,34,32,16,0,1585,1410
Random,26,0.4222222222222222,0.5777777777777777,14,13,0,21,1585,1431
Random,37,0.42857142857142855,0.5714285714285714,19,18,0,35,1585,1466
CardCounter,35,0.42391304347826086,0.5760869565217391,19,18,40,0,1625,1466
CardCounter,24,0.41935483870967744,0.5806451612903226,15,14,35,0,1660,1466
Random,40,0.425531914893617,0.574468085106383,22,22,0,21,1660,1487
Random,17,0.43157894736842106,0.5684210526315789,10,8,0,147,1660,1634
CardCounter,56,0.4270833333333333,0.5729166666666666,29,29,14,0,1674,1634
CardCounter,26,0.422680412371134,0.5773195876288659,13,13,21,0,1695,1634
Random,50,0.42857142857142855,0.5714285714285714,26,25,0,34,1695,1668
CardCounter,14,0.42424242424242425,0.5757575757575758,7,7,18,0,1713,1668
CardCounter,53,0.42,0.58,30,27,19,0,1732,1668
Random,41,0.42574257425742573,0.5742574257425742,22,20,0,14,1732,1682
CardCounter,21,0.4215686274509804,0.5784313725490197,11,12,14,0,1746,1682
CardCounter,12,0.4174757281553398,0.5825242718446602,9,6,9,0,1755,1682
Random,14,0.4230769230769231,0.5769230769230769,7,7,0,8,1755,1690
CardCounter,18,0.41904761904761906,0.580952380952381,10,9,56,0,1811,1690
Random,132,0.42452830188679247,0.5754716981132075,70,72,0,2,1811,1692
CardCounter,72,0.4205607476635514,0.5794392523364486,41,38,30,0,1841,1692
Random,13,0.42592592592592593,0.5740740740740741,6,7,0,55,1841,1747
CardCounter,28,0.42201834862385323,0.5779816513761468,14,14,52,0,1893,1747
Random,34,0.42727272727272725,0.5727272727272728,17,19,0,8,1893,1755
Random,13,0.43243243243243246,0.5675675675675675,8,6,0,51,1893,1806
Random,42,0.4375,0.5625,22,24,0,41,1893,1847
Random,73,0.4424778761061947,0.5575221238938053,41,36,0,81,1893,1928
CardCounter,85,0.43859649122807015,0.5614035087719298,44,45,34,0,1927,1928
CardCounter,40,0.43478260869565216,0.5652173913043478,22,20,8,0,1935,1928
Random,30,0.4396551724137931,0.5603448275862069,15,16,0,29,1935,1957
Random,163,0.4444444444444444,0.5555555555555556,88,83,0,67,1935,2024
CardCounter,15,0.4406779661016949,0.559322033898305,7,8,18,0,1953,2024
Random,31,0.44537815126050423,0.5546218487394958,19,15,0,7,1953,2031
CardCounter,15,0.44166666666666665,0.5583333333333333,7,9,44,0,1997,2031
CardCounter,60,0.4380165289256198,0.5619834710743802,33,30,31,0,2028,2031
CardCounter,27,0.4344262295081967,0.5655737704918032,13,15,33,0,2061,2031
CardCounter,20,0.43089430894308944,0.5691056910569106,13,10,37,0,2098,2031
Random,108,0.43548387096774194,0.5645161290322581,58,57,0,29,2098,2060
Random,29,0.44,0.56,17,17,0,75,2098,2135
CardCounter,13,0.4365079365079365,0.5634920634920635,6,9,27,0,2125,2135
CardCounter,20,0.4330708661417323,0.5669291338582677,11,10,41,0,2166,2135
CardCounter,11,0.4296875,0.5703125,5,8,11,0,2177,2135
CardCounter,31,0.4263565891472868,0.5736434108527132,16,18,21,0,2198,2135
Random,20,0.4307692307692308,0.5692307692307692,10,10,0,29,2198,2164
Random,23,0.4351145038167939,0.5648854961832062,12,11,0,73,2198,2237
CardCounter,25,0.4318181818181818,0.5681818181818182,12,15,42,0,2240,2237
Random,25,0.43609022556390975,0.5639097744360902,15,12,0,20,2240,2257
CardCounter,63,0.43283582089552236,0.5671641791044776,35,34,18,0,2258,2257
Random,31,0.43703703703703706,0.562962962962963,17,15,0,30,2258,2287
CardCounter,51,0.4338235294117647,0.5661764705882353,28,29,52,0,2310,2287
Random,37,0.43795620437956206,0.5620437956204379,21,21,0,25,2310,2312
CardCounter,17,0.43478260869565216,0.5652173913043478,9,11,47,0,2357,2312
CardCounter,28,0.4316546762589928,0.5683453237410072,15,16,12,0,2369,2312
CardCounter,13,0.42857142857142855,0.5714285714285714,6,9,67,0,2436,2312
Random,13,0.4326241134751773,0.5673758865248227,7,6,0,48,2436,2360
CardCounter,95,0.4295774647887324,0.5704225352112676,51,48,23,0,2459,2360
Random,31,0.43356643356643354,0.5664335664335665,17,15,0,27,2459,2387
Random,14,0.4375,0.5625,7,9,0,34,2459,2421
CardCounter,26,0.43448275862068964,0.5655172413793104,13,13,19,0,2478,2421
CardCounter,29,0.4315068493150685,0.5684931506849316,15,16,20,0,2498,2421
CardCounter,26,0.42857142857142855,0.5714285714285714,13,13,84,0,2582,2421
CardCounter,41,0.42567567567567566,0.5743243243243243,22,22,11,0,2593,2421
Random,33,0.42953020134228187,0.5704697986577181,18,16,0,10,2593,2431
CardCounter,17,0.4266666666666667,0.5733333333333334,11,9,35,0,2628,2431
Random,15,0.4304635761589404,0.5695364238410596,8,7,0,65,2628,2496
CardCounter,31,0.4276315789473684,0.5723684210526315,15,17,30,0,2658,2496
CardCounter,30,0.42483660130718953,0.5751633986928104,15,15,31,0,2689,2496
CardCounter,23,0.42207792207792205,0.577922077922078,11,12,2,0,2691,2496
Random,21,0.4258064516129032,0.5741935483870968,13,10,0,24,2691,2520
Random,34,0.42948717948717946,0.5705128205128205,17,21,0,0,2691,2520
Random,109,0.43312101910828027,0.5668789808917197,57,58,0,6,2691,2526
Random,24,0.43670886075949367,0.5632911392405063,12,12,0,54,2691,2580
Random,89,0.44025157232704404,0.559748427672956,50,46,0,5,2691,2585
CardCounter,17,0.4375,0.5625,8,11,23,0,2714,2585
CardCounter,54,0.43478260869565216,0.5652173913043478,27,29,5,0,2719,2585
CardCounter,21,0.43209876543209874,0.5679012345679012,12,11,20,0,2739,2585
CardCounter,48,0.4294478527607362,0.5705521472392638,27,25,9,0,2748,2585
Random,14,0.4329268292682927,0.5670731707317073,7,7,0,28,2748,2613
Random,39,0.43636363636363634,0.5636363636363636,23,23,0,51,2748,2664
Random,38,0.4397590361445783,0.5602409638554217,20,21,0,59,2748,2723
Random,13,0.4431137724550898,0.5568862275449101,7,7,0,25,2748,2748
CardCounter,16,0.44047619047619047,0.5595238095238095,12,8,58,0,2806,2748
Random,25,0.4437869822485207,0.5562130177514792,13,12,0,57,2806,2805
CardCounter,23,0.4411764705882353,0.5588235294117647,12,12,45,0,2851,2805
Random,31,0.4444444444444444,0.5555555555555556,16,19,0,35,2851,2840
CardCounter,39,0.4418604651162791,0.5581395348837209,19,20,33,0,2884,2840
CardCounter,22,0.4393063583815029,0.5606936416184971,13,11,79,0,2963,2840
Random,20,0.4425287356321839,0.5574712643678161,11,12,0,51,2963,2891
Random,15,0.44571428571428573,0.5542857142857143,10,7,0,3,2963,2894
Random,36,0.44886363636363635,0.5511363636363636,19,18,0,40,2963,2934
Random,13,0.4519774011299435,0.5480225988700564,9,6,0,43,2963,2977
CardCounter,25,0.449438202247191,0.550561797752809,12,15,26,0,2989,2977
CardCounter,48,0.44692737430167595,0.553072625698324,25,27,62,0,3051,2977
Random,20,0.45,0.55,10,10,0,23,3051,3000
CardCounter,46,0.44751381215469616,0.5524861878453039,27,23,46,0,3097,3000
CardCounter,17,0.44505494505494503,0.554945054945055,8,10,45,0,3142,3000
CardCounter,50,0.4426229508196721,0.5573770491803278,25,25,15,0,3157,3000
CardCounter,25,0.44021739130434784,0.5597826086956522,12,13,35,0,3192,3000
Random,63,0.44324324324324327,0.5567567567567567,36,35,0,9,3192,3009
CardCounter,17,0.44086021505376344,0.5591397849462365,8,9,13,0,3205,3009
Random,79,0.44385026737967914,0.5561497326203209,40,41,0,41,3205,3050
Random,20,0.44680851063829785,0.5531914893617021,11,10,0,12,3205,3062
Random,29,0.4497354497354497,0.5502645502645502,16,14,0,31,3205,3093
Random,18,0.45263157894736844,0.5473684210526316,9,9,0,66,3205,3159
Random,39,0.45549738219895286,0.5445026178010471,21,22,0,6,3205,3165
CardCounter,25,0.453125,0.546875,12,14,16,0,3221,3165
CardCounter,96,0.45077720207253885,0.5492227979274611,51,52,32,0,3253,3165
CardCounter,21,0.4484536082474227,0.5515463917525774,10,12,27,0,3280,3165
Random,23,0.4512820512820513,0.5487179487179488,14,13,0,0,3280,3165
CardCounter,17,0.4489795918367347,0.5510204081632653,10,9,4,0,3284,3165
CardCounter,14,0.4467005076142132,0.5532994923857868,8,7,23,0,3307,3165
CardCounter,29,0.4444444444444444,0.5555555555555556,15,15,2,0,3309,3165
CardCounter,20,0.44221105527638194,0.5577889447236181,10,10,43,0,3352,3165
CardCounter,26,0.44,0.56,13,16,33,0,3385,3165
Random,13,0.4427860696517413,0.5572139303482587,8,8,0,45,3385,3210
Random,20,0.44554455445544555,0.5544554455445545,10,10,0,74,3385,3284
CardCounter,34,0.4433497536945813,0.5566502463054187,18,18,62,0,3447,3284
CardCounter,37,0.4411764705882353,0.5588235294117647,19,19,62,0,3509,3284
Random,11,0.44390243902439025,0.5560975609756098,7,5,0,91,3509,3375
Random,36,0.44660194174757284,0.5533980582524272,18,18,0,19,3509,3394
Random,35,0.4492753623188406,0.5507246376811594,21,17,0,10,3509,3404
Random,14,0.4519230769230769,0.5480769230769231,7,7,0,13,3509,3417
CardCounter,16,0.44976076555023925,0.5502392344497608,8,10,7,0,3516,3417
Random,38,0.4523809523809524,0.5476190476190477,21,20,0,40,3516,3457
Random,75,0.4549763033175355,0.5450236966824644,40,39,0,20,3516,3477
Random,18,0.45754716981132076,0.5424528301886793,9,9,0,14,3516,3491
CardCounter,68,0.45539906103286387,0.5446009389671361,36,38,0,0,3516,3491
Random,42,0.45794392523364486,0.5420560747663551,24,24,0,24,3516,3515
CardCounter,94,0.4558139534883721,0.5441860465116279,48,49,43,0,3559,3515
CardCounter,51,0.4537037037037037,0.5462962962962963,26,28,20,0,3579,3515
CardCounter,18,0.45161290322580644,0.5483870967741935,11,10,34,0,3613,3515
CardCounter,155,0.44954128440366975,0.5504587155963303,81,83,109,0,3722,3515
CardCounter,30,0.4474885844748858,0.5525114155251142,18,16,11,0,3733,3515
CardCounter,13,0.44545454545454544,0.5545454545454546,6,7,63,0,3796,3515
CardCounter,64,0.4434389140271493,0.5565610859728507,35,34,6,0,3802,3515
CardCounter,17,0.44144144144144143,0.5585585585585585,8,9,25,0,3827,3515
CardCounter,22,0.43946188340807174,0.5605381165919282,11,12,2,0,3829,3515
CardCounter,43,0.4375,0.5625,22,24,10,0,3839,3515
CardCounter,52,0.43555555555555553,0.5644444444444444,27,28,9,0,3848,3515
Random,56,0.43805309734513276,0.5619469026548672,30,31,0,82,3848,3597
CardCounter,18,0.43612334801762115,0.5638766519823789,10,9,16,0,3864,3597
CardCounter,29,0.4342105263157895,0.5657894736842105,16,15,5,0,3869,3597
Random,29,0.4366812227074236,0.5633187772925764,16,14,0,72,3869,3669
CardCounter,11,0.43478260869565216,0.5652173913043478,6,6,102,0,3971,3669
CardCounter,20,0.4329004329004329,0.5670995670995671,11,10,7,0,3978,3669
CardCounter,19,0.43103448275862066,0.5689655172413793,9,10,57,0,4035,3669
CardCounter,16,0.4291845493562232,0.5708154506437768,8,9,63,0,4098,3669
Random,158,0.43162393162393164,0.5683760683760684,82,86,0,20,4098,3689
CardCounter,40,0.4297872340425532,0.5702127659574469,22,21,37,0,4135,3689
CardCounter,49,0.4279661016949153,0.5720338983050848,26,27,22,0,4157,3689
Random,29,0.43037974683544306,0.569620253164557,18,15,0,52,4157,3741
Random,88,0.4327731092436975,0.5672268907563025,47,47,0,56,4157,3797
CardCounter,60,0.4309623430962343,0.5690376569037657,32,31,6,0,4163,3797
Random,70,0.43333333333333335,0.5666666666666667,39,36,0,20,4163,3817
Random,17,0.43568464730290457,0.5643153526970954,9,8,0,50,4163,3867
Random,16,0.4380165289256198,0.5619834710743802,8,8,0,41,4163,3908
CardCounter,56,0.43621399176954734,0.5637860082304527,32,31,47,0,4210,3908
Random,138,0.4385245901639344,0.5614754098360656,71,76,0,35,4210,3943
CardCounter,22,0.43673469387755104,0.563265306122449,11,13,44,0,4254,3943
CardCounter,9,0.4349593495934959,0.5650406504065041,4,7,66,0,4320,3943
CardCounter,62,0.4331983805668016,0.5668016194331984,35,33,7,0,4327,3943
CardCounter,25,0.4314516129032258,0.5685483870967742,12,13,20,0,4347,3943
CardCounter,16,0.42971887550200805,0.570281124497992,8,10,21,0,4368,3943
CardCounter,17,0.428,0.572,8,9,13,0,4381,3943
Random,19,0.4302788844621514,0.5697211155378487,11,9,0,84,4381,4027
CardCounter,15,0.42857142857142855,0.5714285714285714,8,8,21,0,4402,4027
CardCounter,64,0.4268774703557312,0.5731225296442688,36,34,18,0,4420,4027
CardCounter,105,0.4251968503937008,0.5748031496062992,57,55,4,0,4424,4027
CardCounter,106,0.4235294117647059,0.5764705882352941,55,59,26,0,4450,4027
Random,60,0.42578125,0.57421875,32,33,0,8,4450,4035
CardCounter,48,0.42412451361867703,0.5758754863813229,26,26,13,0,4463,4035
CardCounter,27,0.42248062015503873,0.5775193798449613,13,15,59,0,4522,4035
CardCounter,18,0.42084942084942084,0.5791505791505791,9,10,58,0,4580,4035
CardCounter,19,0.41923076923076924,0.5807692307692308,9,12,7,0,4587,4035
Random,15,0.421455938697318,0.578544061302682,8,7,0,71,4587,4106
Random,26,0.42366412213740456,0.5763358778625954,14,14,0,24,4587,4130
Random,81,0.42585551330798477,0.5741444866920152,43,40,0,11,4587,4141
Random,32,0.42803030303030304,0.571969696969697,18,16,0,22,4587,4163
Random,33,0.43018867924528303,0.569811320754717,17,17,0,25,4587,4188
CardCounter,13,0.42857142857142855,0.5714285714285714,7,7,11,0,4598,4188
CardCounter,36,0.42696629213483145,0.5730337078651685,19,18,33,0,4631,4188
CardCounter,65,0.4253731343283582,0.5746268656716418,32,36,53,0,4684,4188
Random,45,0.4275092936802974,0.5724907063197026,26,22,0,32,4684,4220
Random,66,0.42962962962962964,0.5703703703703704,34,37,0,23,4684,4243
CardCounter,12,0.4280442804428044,0.5719557195571956,7,6,50,0,4734,4243
CardCounter,25,0.4264705882352941,0.5735294117647058,13,13,31,0,4765,4243
CardCounter,14,0.4249084249084249,0.575091575091575,7,7,43,0,4808,4243
Random,24,0.42700729927007297,0.572992700729927,14,13,0,24,4808,4267
Random,53,0.4290909090909091,0.5709090909090909,31,28,0,10,4808,4277
Random,134,0.4311594202898551,0.5688405797101449,70,73,0,5,4808,4282
CardCounter,34,0.4296028880866426,0.5703971119133574,19,17,36,0,4844,4282
Random,72,0.4316546762589928,0.5683453237410072,40,38,0,0,4844,4282
CardCounter,12,0.43010752688172044,0.5698924731182796,7,7,39,0,4883,4282
CardCounter,29,0.42857142857142855,0.5714285714285714,14,15,4,0,4887,4282
CardCounter,18,0.42704626334519574,0.5729537366548043,9,11,32,0,4919,4282
CardCounter,23,0.425531914893617,0.574468085106383,12,12,13,0,4932,4282
Random,45,0.4275618374558304,0.5724381625441696,23,22,0,20,4932,4302
CardCounter,17,0.426056338028169,0.573943661971831,8,11,21,0,4953,4302
CardCounter,24,0.4245614035087719,0.5754385964912281,12,13,78,0,5031,4302
CardCounter,23,0.4230769230769231,0.5769230769230769,13,13,55,0,5086,4302
Random,51,0.4250871080139373,0.5749128919860628,29,25,0,32,5086,4334
CardCounter,13,0.4236111111111111,0.5763888888888888,6,7,39,0,5125,4334
CardCounter,28,0.42214532871972316,0.5778546712802768,14,16,47,0,5172,4334
CardCounter,21,0.4206896551724138,0.5793103448275863,10,12,19,0,5191,4334
CardCounter,14,0.41924398625429554,0.5807560137457045,7,7,40,0,5231,4334
CardCounter,25,0.4178082191780822,0.5821917808219178,15,13,5,0,5236,4334
CardCounter,48,0.41638225255972694,0.5836177474402731,28,26,26,0,5262,4334
Random,22,0.41836734693877553,0.5816326530612245,11,12,0,27,5262,4361
CardCounter,18,0.41694915254237286,0.5830508474576271,9,12,60,0,5322,4361
CardCounter,37,0.4155405405405405,0.5844594594594594,19,19,32,0,5354,4361
CardCounter,62,0.41414141414141414,0.5858585858585859,31,35,21,0,5375,4361
CardCounter,13,0.412751677852349,0.587248322147651,6,9,73,0,5448,4361
CardCounter,30,0.411371237458194,0.5886287625418061,19,16,1,0,5449,4361
CardCounter,147,0.41,0.59,76,79,35,0,5484,4361
CardCounter,12,0.40863787375415284,0.5913621262458472,7,6,83,0,5567,4361
Random,14,0.4105960264900662,0.5894039735099338,8,7,0,6,5567,4367
Random,49,0.41254125412541254,0.5874587458745875,29,26,0,0,5567,4367
CardCounter,15,0.41118421052631576,0.5888157894736842,8,8,15,0,5582,4367
Random,23,0.4131147540983607,0.5868852459016394,15,13,0,20,5582,4387
Random,40,0.4150326797385621,0.5849673202614379,21,21,0,14,5582,4401
Random,13,0.4169381107491857,0.5830618892508144,7,6,0,75,5582,4476
CardCounter,71,0.4155844155844156,0.5844155844155844,36,40,3,0,5585,4476
CardCounter,28,0.41423948220064727,0.5857605177993528,16,14,28,0,5613,4476
CardCounter,19,0.4129032258064516,0.5870967741935483,9,10,32,0,5645,4476
CardCounter,36,0.4115755627009646,0.5884244372990354,19,20,20,0,5665,4476
Random,30,0.41346153846153844,0.5865384615384616,17,15,0,0,5665,4476
CardCounter,80,0.41214057507987223,0.5878594249201278,44,44,23,0,5688,4476
Random,84,0.4140127388535032,0.5859872611464968,43,44,0,29,5688,4505
Random,87,0.4158730158730159,0.5841269841269842,48,45,0,40,5688,4545
CardCounter,53,0.41455696202531644,0.5854430379746836,26,29,17,0,5705,4545
Random,11,0.416403785488959,0.583596214511041,8,5,0,64,5705,4609
CardCounter,79,0.41509433962264153,0.5849056603773585,42,42,17,0,5722,4609
CardCounter,38,0.41379310344827586,0.5862068965517241,19,22,48,0,5770,4609
CardCounter,41,0.4125,0.5875,22,25,1,0,5771,4609
Random,23,0.4143302180685358,0.5856697819314641,12,12,0,12,5771,4621
Random,42,0.4161490683229814,0.5838509316770186,24,21,0,25,5771,4646
CardCounter,14,0.4148606811145511,0.5851393188854489,8,7,61,0,5832,4646
Random,30,0.4166666666666667,0.5833333333333334,15,16,0,51,5832,4697
Random,23,0.41846153846153844,0.5815384615384616,13,11,0,5,5832,4702
CardCounter,45,0.4171779141104294,0.5828220858895705,26,23,24,0,5856,4702
CardCounter,14,0.41590214067278286,0.5840978593272171,8,9,95,0,5951,4702
Random,62,0.4176829268292683,0.5823170731707317,33,31,0,72,5951,4774
CardCounter,12,0.41641337386018235,0.5835866261398176,8,7,32,0,5983,4774
Random,14,0.41818181818181815,0.5818181818181818,7,7,0,13,5983,4787
CardCounter,36,0.4169184290030212,0.5830815709969789,20,18,71,0,6054,4787
CardCounter,11,0.41566265060240964,0.5843373493975904,6,7,123,0,6177,4787
CardCounter,12,0.4144144144144144,0.5855855855855856,6,7,34,0,6211,4787
CardCounter,13,0.41317365269461076,0.5868263473053892,6,7,24,0,6235,4787
Random,17,0.41492537313432837,0.5850746268656717,9,8,0,3,6235,4790
CardCounter,23,0.41369047619047616,0.5863095238095238,13,12,47,0,6282,4790
Random,77,0.41543026706231456,0.5845697329376854,41,41,0,26,6282,4816
Random,51,0.4171597633136095,0.5828402366863905,25,26,0,68,6282,4884
CardCounter,34,0.415929203539823,0.584070796460177,17,19,27,0,6309,4884
Random,44,0.4176470588235294,0.5823529411764706,25,24,0,31,6309,4915
Random,43,0.41935483870967744,0.5806451612903226,23,22,0,50,6309,4965
CardCounter,19,0.41812865497076024,0.5818713450292398,10,10,25,0,6334,4965
CardCounter,18,0.41690962099125367,0.5830903790087464,9,9,7,0,6341,4965
CardCounter,21,0.41569767441860467,0.5843023255813954,10,11,25,0,6366,4965
CardCounter,18,0.4144927536231884,0.5855072463768116,9,9,15,0,6381,4965
CardCounter,29,0.41329479768786126,0.5867052023121387,16,16,83,0,6464,4965
CardCounter,14,0.41210374639769454,0.5878962536023055,7,7,39,0,6503,4965
Random,14,0.41379310344827586,0.5862068965517241,7,7,0,78,6503,5043
CardCounter,14,0.41260744985673353,0.5873925501432665,7,7,24,0,6527,5043
Random,154,0.4142857142857143,0.5857142857142857,80,85,0,29,6527,5072
Random,15,0.41595441595441596,0.584045584045584,10,9,0,27,6527,5099
CardCounter,63,0.4147727272727273,0.5852272727272727,34,33,84,0,6611,5099
CardCounter,20,0.41359773371104813,0.5864022662889519,10,12,28,0,6639,5099
Random,26,0.4152542372881356,0.5847457627118644,16,13,0,36,6639,5135
Random,43,0.4169014084507042,0.5830985915492958,23,21,0,77,6639,5212
Random,22,0.41853932584269665,0.5814606741573034,11,12,0,37,6639,5249
Random,17,0.42016806722689076,0.5798319327731093,9,8,0,33,6639,5282
Random,84,0.42178770949720673,0.5782122905027933,45,44,0,20,6639,5302
Random,27,0.4233983286908078,0.5766016713091922,14,14,0,19,6639,5321
CardCounter,15,0.4222222222222222,0.5777777777777777,7,9,30,0,6669,5321
CardCounter,26,0.42105263157894735,0.5789473684210527,14,14,10,0,6679,5321
CardCounter,23,0.4198895027624309,0.580110497237569,12,13,65,0,6744,5321
CardCounter,26,0.418732782369146,0.581267217630854,14,13,30,0,6774,5321
Random,58,0.42032967032967034,0.5796703296703297,30,29,0,23,6774,5344
CardCounter,28,0.4191780821917808,0.5808219178082191,14,16,11,0,6785,5344
Random,52,0.4207650273224044,0.5792349726775956,27,27,0,21,6785,5365
CardCounter,12,0.4196185286103542,0.5803814713896458,10,6,59,0,6844,5365
CardCounter,11,0.41847826086956524,0.5815217391304348,8,6,96,0,6940,5365
Random,19,0.42005420054200543,0.5799457994579946,11,11,0,36,6940,5401
Random,32,0.42162162162162165,0.5783783783783784,19,17,0,44,6940,5445
CardCounter,116,0.42048517520215634,0.5795148247978437,64,62,51,0,6991,5445
Random,26,0.4220430107526882,0.5779569892473119,14,13,0,5,6991,5450
CardCounter,30,0.42091152815013405,0.579088471849866,15,15,26,0,7017,5450
Random,28,0.42245989304812837,0.5775401069518716,17,14,0,79,7017,5529
CardCounter,76,0.42133333333333334,0.5786666666666667,43,40,14,0,7031,5529
CardCounter,21,0.42021276595744683,0.5797872340425532,11,11,22,0,7053,5529
Random,37,0.4217506631299735,0.5782493368700266,20,19,0,0,7053,5529
Random,40,0.42328042328042326,0.5767195767195767,21,21,0,60,7053,5589
Random,91,0.42480211081794195,0.575197889182058,49,47,0,28,7053,5617
CardCounter,33,0.4236842105263158,0.5763157894736842,16,17,129,0,7182,5617
CardCounter,23,0.4225721784776903,0.5774278215223098,12,11,56,0,7238,5617
Random,32,0.42408376963350786,0.5759162303664922,19,18,0,24,7238,5641
Random,25,0.4255874673629243,0.5744125326370757,15,13,0,23,7238,5664
CardCounter,67,0.4244791666666667,0.5755208333333334,35,35,32,0,7270,5664
CardCounter,12,0.42337662337662335,0.5766233766233766,7,6,36,0,7306,5664
CardCounter,69,0.422279792746114,0.5777202072538861,38,36,31,0,7337,5664
Random,23,0.42377260981912146,0.5762273901808785,13,11,0,45,7337,5709
CardCounter,25,0.422680412371134,0.5773195876288659,13,14,3,0,7340,5709
CardCounter,74,0.42159383033419023,0.5784061696658098,39,38,0,0,7340,5709
CardCounter,39,0.4205128205128205,0.5794871794871795,20,22,17,0,7357,5709
CardCounter,36,0.4194373401534527,0.5805626598465473,19,18,45,0,7402,5709
CardCounter,17,0.41836734693877553,0.5816326530612245,9,10,21,0,7423,5709
CardCounter,10,0.4173027989821883,0.5826972010178118,5,7,66,0,7489,5709
CardCounter,29,0.41624365482233505,0.583756345177665,15,16,31,0,7520,5709
Random,27,0.4177215189873418,0.5822784810126582,15,14,0,20,7520,5729
CardCounter,23,0.4166666666666667,0.5833333333333334,12,12,40,0,7560,5729
Random,47,0.4181360201511335,0.5818639798488665,26,24,0,24,7560,5753
Random,32,0.41959798994974873,0.5804020100502513,18,18,0,66,7560,5819
CardCounter,22,0.41854636591478694,0.581453634085213,11,11,26,0,7586,5819
CardCounter,35,0.4175,0.5825,18,20,19,0,7605,5819
CardCounter,12,0.4164588528678304,0.5835411471321695,6,7,33,0,7638,5819
CardCounter,19,0.4154228855721393,0.5845771144278606,10,12,18,0,7656,5819
Random,21,0.41687344913151364,0.5831265508684863,11,10,0,61,7656,5880
CardCounter,69,0.4158415841584158,0.5841584158415841,35,38,4,0,7660,5880
CardCounter,14,0.4148148148148148,0.5851851851851851,9,7,24,0,7684,5880
CardCounter,13,0.41379310344827586,0.5862068965517241,6,7,13,0,7697,5880
CardCounter,22,0.41277641277641275,0.5872235872235873,12,13,0,0,7697,5880
Random,20,0.41421568627450983,0.5857843137254902,11,12,0,49,7697,5929
CardCounter,50,0.4132029339853301,0.58679706601467,26,27,10,0,7707,5929
CardCounter,29,0.4121951219512195,0.5878048780487805,14,17,29,0,7736,5929
Random,63,0.41362530413625304,0.5863746958637469,34,35,0,26,7736,5955
CardCounter,9,0.41262135922330095,0.587378640776699,5,6,21,0,7757,5955
Random,15,0.41404358353510895,0.585956416464891,10,7,0,0,7757,5955
CardCounter,26,0.41304347826086957,0.5869565217391305,15,14,7,0,7764,5955
CardCounter,92,0.41204819277108434,0.5879518072289157,50,47,17,0,7781,5955
Random,30,0.41346153846153844,0.5865384615384616,15,15,0,9,7781,5964
CardCounter,80,0.41247002398081534,0.5875299760191847,44,41,1,0,7782,5964
Random,12,0.4138755980861244,0.5861244019138756,7,6,0,33,7782,5997
Random,25,0.4152744630071599,0.5847255369928401,14,12,0,50,7782,6047
Random,22,0.4166666666666667,0.5833333333333334,15,11,0,29,7782,6076
CardCounter,46,0.4156769596199525,0.5843230403800475,26,25,6,0,7788,6076
CardCounter,207,0.4146919431279621,0.5853080568720379,108,108,25,0,7813,6076
Random,45,0.4160756501182033,0.5839243498817966,24,24,0,2,7813,6078
CardCounter,29,0.41509433962264153,0.5849056603773585,14,15,4,0,7817,6078
Random,13,0.4164705882352941,0.5835294117647059,7,6,0,77,7817,6155
Random,16,0.41784037558685444,0.5821596244131455,8,8,0,31,7817,6186
Random,21,0.41920374707259955,0.5807962529274004,13,11,0,40,7817,6226
Random,18,0.4205607476635514,0.5794392523364486,12,10,0,25,7817,6251
CardCounter,18,0.4195804195804196,0.5804195804195804,9,9,34,0,7851,6251
Random,46,0.42093023255813955,0.5790697674418605,25,23,0,33,7851,6284
CardCounter,28,0.419953596287703,0.580046403712297,17,14,26,0,7877,6284
Random,14,0.4212962962962963,0.5787037037037037,7,7,0,117,7877,6401
Random,85,0.4226327944572748,0.5773672055427251,47,44,0,22,7877,6423
CardCounter,167,0.4216589861751152,0.5783410138248848,89,89,28,0,7905,6423
Random,53,0.42298850574712643,0.5770114942528736,28,29,0,16,7905,6439
Random,26,0.4243119266055046,0.5756880733944955,14,15,0,38,7905,6477
CardCounter,26,0.4233409610983982,0.5766590389016019,13,15,28,0,7933,6477
CardCounter,55,0.4223744292237443,0.5776255707762558,29,28,20,0,7953,6477
CardCounter,36,0.4214123006833713,0.5785876993166287,19,19,8,0,7961,6477
CardCounter,43,0.42045454545454547,0.5795454545454546,24,23,0,0,7961,6477
CardCounter,24,0.41950113378684806,0.5804988662131519,12,13,22,0,7983,6477
Random,14,0.42081447963800905,0.579185520361991,7,8,0,5,7983,6482
Random,9,0.4221218961625282,0.5778781038374717,7,4,0,30,7983,6512
Random,24,0.42342342342342343,0.5765765765765766,14,12,0,28,7983,6540
Random,11,0.4247191011235955,0.5752808988764045,8,5,0,27,7983,6567
CardCounter,17,0.42376681614349776,0.5762331838565022,9,11,48,0,8031,6567
Random,35,0.4250559284116331,0.5749440715883669,21,17,0,19,8031,6586
CardCounter,23,0.42410714285714285,0.5758928571428571,11,13,18,0,8049,6586
CardCounter,18,0.42316258351893093,0.576837416481069,9,9,63,0,8112,6586
CardCounter,37,0.4222222222222222,0.5777777777777777,21,19,49,0,8161,6586
Random,45,0.42350332594235035,0.5764966740576497,27,22,0,29,8161,6615
Random,16,0.4247787610619469,0.5752212389380531,11,8,0,15,8161,6630
Random,95,0.4260485651214128,0.5739514348785872,50,50,0,102,8161,6732
Random,144,0.42731277533039647,0.5726872246696035,75,76,0,61,8161,6793
Random,59,0.42857142857142855,0.5714285714285714,31,33,0,5,8161,6798
Random,26,0.4298245614035088,0.5701754385964912,13,15,0,120,8161,6918
Random,25,0.4310722100656455,0.5689277899343544,13,12,0,26,8161,6944
Random,24,0.43231441048034935,0.5676855895196506,14,12,0,22,8161,6966
Random,29,0.4335511982570806,0.5664488017429193,16,14,0,9,8161,6975
CardCounter,35,0.4326086956521739,0.5673913043478261,19,20,16,0,8177,6975
Random,45,0.43383947939262474,0.5661605206073753,24,23,0,54,8177,7029
CardCounter,15,0.4329004329004329,0.5670995670995671,8,8,41,0,8218,7029
CardCounter,36,0.4319654427645788,0.5680345572354212,18,18,36,0,8254,7029
Random,68,0.4331896551724138,0.5668103448275862,38,37,0,5,8254,7034
CardCounter,30,0.432258064516129,0.567741935483871,17,17,24,0,8278,7034
Random,80,0.4334763948497854,0.5665236051502146,44,43,0,13,8278,7047
Random,13,0.4346895074946467,0.5653104925053534,9,6,0,27,8278,7074
CardCounter,13,0.4337606837606838,0.5662393162393162,7,7,23,0,8301,7074
CardCounter,30,0.43283582089552236,0.5671641791044776,17,15,29,0,8330,7074
CardCounter,39,0.4319148936170213,0.5680851063829787,21,23,19,0,8349,7074
Random,23,0.43312101910828027,0.5668789808917197,12,11,0,13,8349,7087
Random,22,0.4343220338983051,0.565677966101695,11,11,0,12,8349,7099
CardCounter,64,0.4334038054968288,0.5665961945031712,35,36,33,0,8382,7099
Random,62,0.4345991561181435,0.5654008438818565,33,32,0,28,8382,7127
Random,29,0.4357894736842105,0.5642105263157895,15,14,0,43,8382,7170
CardCounter,37,0.43487394957983194,0.5651260504201681,21,21,25,0,8407,7170
Random,49,0.4360587002096436,0.5639412997903563,26,27,0,108,8407,7278
Random,82,0.4372384937238494,0.5627615062761506,44,43,0,126,8407,7404
Random,23,0.4384133611691023,0.5615866388308977,14,12,0,20,8407,7424
Random,34,0.4395833333333333,0.5604166666666667,19,18,0,38,8407,7462
Random,63,0.4407484407484408,0.5592515592515592,35,31,0,43,8407,7505
CardCounter,23,0.43983402489626555,0.5601659751037344,12,12,29,0,8436,7505
Random,19,0.4409937888198758,0.5590062111801242,13,9,0,58,8436,7563
CardCounter,13,0.44008264462809915,0.5599173553719008,6,7,35,0,8471,7563
CardCounter,64,0.43917525773195876,0.5608247422680412,33,35,20,0,8491,7563
CardCounter,21,0.4382716049382716,0.5617283950617284,10,11,46,0,8537,7563
Random,29,0.4394250513347023,0.5605749486652978,15,15,0,140,8537,7703
CardCounter,141,0.4385245901639344,0.5614754098360656,74,75,31,0,8568,7703
CardCounter,20,0.4376278118609407,0.5623721881390593,12,12,47,0,8615,7703
CardCounter,89,0.43673469387755104,0.563265306122449,48,48,7,0,8622,7703
CardCounter,14,0.43584521384928715,0.5641547861507128,9,7,28,0,8650,7703
CardCounter,9,0.4349593495934959,0.5650406504065041,5,6,46,0,8696,7703
CardCounter,24,0.4340770791075051,0.565922920892495,12,14,25,0,8721,7703
CardCounter,11,0.4331983805668016,0.5668016194331984,6,6,71,0,8792,7703
CardCounter,130,0.43232323232323233,0.5676767676767677,70,68,34,0,8826,7703
CardCounter,9,0.4314516129032258,0.5685483870967742,4,7,56,0,8882,7703
Random,19,0.43259557344064387,0.5674044265593562,11,9,0,26,8882,7729
Random,14,0.43373493975903615,0.5662650602409639,8,7,0,55,8882,7784
Random,61,0.4348697394789579,0.5651302605210421,34,32,0,9,8882,7793
CardCounter,23,0.434,0.566,13,12,0,0,8882,7793
Random,61,0.4351297405189621,0.564870259481038,32,31,0,27,8882,7820
CardCounter,29,0.4342629482071713,0.5657370517928287,15,16,71,0,8953,7820
Random,57,0.43538767395626243,0.5646123260437376,29,28,0,0,8953,7820
Random,28,0.4365079365079365,0.5634920634920635,14,17,0,108,8953,7928
CardCounter,46,0.43564356435643564,0.5643564356435643,27,25,54,0,9007,7928
CardCounter,19,0.43478260869565216,0.5652173913043478,11,14,69,0,9076,7928
Random,15,0.4358974358974359,0.5641025641025641,9,7,0,31,9076,7959
Random,28,0.43700787401574803,0.562992125984252,15,14,0,149,9076,8108
Random,11,0.4381139489194499,0.5618860510805501,8,5,0,36,9076,8144
CardCounter,25,0.4372549019607843,0.5627450980392157,12,13,70,0,9146,8144
Random,25,0.4383561643835616,0.5616438356164384,16,12,0,98,9146,8242
Random,56,0.439453125,0.560546875,30,30,0,6,9146,8248
CardCounter,20,0.43859649122807015,0.5614035087719298,10,12,36,0,9182,8248
Random,40,0.4396887159533074,0.5603112840466926,21,21,0,20,9182,8268
Random,73,0.4407766990291262,0.5592233009708738,40,39,0,27,9182,8295
CardCounter,11,0.43992248062015504,0.560077519379845,5,7,41,0,9223,8295
Random,23,0.4410058027079304,0.5589941972920697,16,11,0,25,9223,8320
Random,104,0.4420849420849421,0.5579150579150579,56,56,0,10,9223,8330
Random,31,0.44315992292870904,0.5568400770712909,16,15,0,55,9223,8385
Random,12,0.4442307692307692,0.5557692307692308,8,6,0,51,9223,8436
Random,25,0.44529750479846447,0.5547024952015355,17,12,0,12,9223,8448
Random,44,0.446360153256705,0.553639846743295,27,24,0,2,9223,8450
Random,45,0.4474187380497132,0.5525812619502868,26,22,0,133,9223,8583
Random,24,0.4484732824427481,0.5515267175572519,12,12,0,45,9223,8628
Random,43,0.44952380952380955,0.5504761904761905,24,21,0,27,9223,8655
CardCounter,17,0.44866920152091255,0.5513307984790875,8,9,75,0,9298,8655
Random,29,0.4497153700189753,0.5502846299810247,15,16,0,60,9298,8715
CardCounter,73,0.44886363636363635,0.5511363636363636,39,38,29,0,9327,8715
Random,51,0.4499054820415879,0.5500945179584121,28,28,0,74,9327,8789
CardCounter,87,0.4490566037735849,0.5509433962264151,48,46,17,0,9344,8789
CardCounter,10,0.448210922787194,0.551789077212806,5,7,79,0,9423,8789
Random,24,0.4492481203007519,0.5507518796992481,13,12,0,21,9423,8810
CardCounter,22,0.44840525328330205,0.551594746716698,11,11,20,0,9443,8810
CardCounter,19,0.44756554307116103,0.552434456928839,11,10,25,0,9468,8810
Random,19,0.4485981308411215,0.5514018691588785,11,11,0,121,9468,8931
CardCounter,13,0.44776119402985076,0.5522388059701493,6,7,27,0,9495,8931
Random,15,0.44878957169459965,0.5512104283054003,9,7,0,37,9495,8968
Random,34,0.44981412639405205,0.550185873605948,17,20,0,38,9495,9006
Random,109,0.45083487940630795,0.549165120593692,56,57,0,60,9495,9066
CardCounter,45,0.45,0.55,25,23,41,0,9536,9066
Random,45,0.4510166358595194,0.5489833641404805,24,24,0,51,9536,9117
Random,94,0.45202952029520294,0.5479704797047971,51,49,0,40,9536,9157
Random,23,0.4530386740331492,0.5469613259668509,12,12,0,25,9536,9182
CardCounter,29,0.4522058823529412,0.5477941176470589,15,16,25,0,9561,9182
Random,51,0.45321100917431195,0.5467889908256881,29,29,0,23,9561,9205
CardCounter,43,0.4523809523809524,0.5476190476190477,21,22,46,0,9607,9205
CardCounter,40,0.4515539305301645,0.5484460694698354,23,21,43,0,9650,9205
Random,30,0.45255474452554745,0.5474452554744526,17,18,0,5,9650,9210
CardCounter,32,0.4517304189435337,0.5482695810564663,18,18,22,0,9672,9210
CardCounter,43,0.4509090909090909,0.5490909090909091,22,23,12,0,9684,9210
Random,15,0.4519056261343013,0.5480943738656987,8,7,0,110,9684,9320
CardCounter,63,0.45108695652173914,0.5489130434782609,34,34,24,0,9708,9320
Random,19,0.45207956600361665,0.5479204339963833,10,9,0,24,9708,9344
CardCounter,21,0.45126353790613716,0.5487364620938628,10,11,38,0,9746,9344
CardCounter,38,0.45045045045045046,0.5495495495495496,19,19,38,0,9784,9344
Random,18,0.45143884892086333,0.5485611510791367,9,9,0,28,9784,9372
Random,15,0.4524236983842011,0.547576301615799,8,10,0,88,9784,9460
Random,56,0.45340501792114696,0.546594982078853,31,30,0,56,9784,9516
Random,27,0.4543828264758497,0.5456171735241503,14,13,0,21,9784,9537
Random,31,0.45535714285714285,0.5446428571428571,15,16,0,26,9784,9563
Random,39,0.4563279857397504,0.5436720142602496,24,20,0,27,9784,9590
Random,60,0.45729537366548045,0.5427046263345195,36,31,0,14,9784,9604
Random,35,0.458259325044405,0.5417406749555951,21,17,0,4,9784,9608
CardCounter,41,0.4574468085106383,0.5425531914893617,22,21,30,0,9814,9608
CardCounter,22,0.45663716814159294,0.5433628318584071,12,12,58,0,9872,9608
CardCounter,13,0.4558303886925795,0.5441696113074205,6,7,44,0,9916,9608
CardCounter,36,0.455026455026455,0.544973544973545,20,19,40,0,9956,9608
CardCounter,9,0.45422535211267606,0.545774647887324,4,7,29,0,9985,9608
Random,77,0.45518453427065025,0.5448154657293497,41,39,0,65,9985,9673
Random,36,0.45614035087719296,0.543859649122807,18,23,0,27,9985,9700
CardCounter,14,0.4553415061295972,0.5446584938704028,7,7,52,0,10037,9700
CardCounter,33,0.45454545454545453,0.5454545454545454,17,18,12,0,10049,9700
Random,21,0.45549738219895286,0.5445026178010471,11,10,0,24,10049,9724
CardCounter,21,0.4547038327526132,0.5452961672473867,10,11,34,0,10083,9724
Random,29,0.45565217391304347,0.5443478260869565,15,16,0,33,10083,9757
CardCounter,37,0.4548611111111111,0.5451388888888888,20,20,89,0,10172,9757
CardCounter,50,0.4540727902946274,0.5459272097053726,25,27,5,0,10177,9757
CardCounter,19,0.4532871972318339,0.5467128027681661,10,11,9,0,10186,9757
CardCounter,12,0.4525043177892919,0.5474956822107081,6,8,56,0,10242,9757
CardCounter,69,0.4517241379310345,0.5482758620689655,39,38,168,0,10410,9757
CardCounter,22,0.4509466437177281,0.5490533562822719,11,11,104,0,10514,9757
Random,16,0.4518900343642612,0.5481099656357389,8,8,0,1,10514,9758
Random,19,0.4528301886792453,0.5471698113207547,11,10,0,70,10514,9828
Random,24,0.4537671232876712,0.5462328767123288,12,12,0,35,10514,9863
Random,15,0.4547008547008547,0.5452991452991452,8,9,0,31,10514,9894
CardCounter,19,0.4539249146757679,0.5460750853242321,9,11,89,0,10603,9894
Random,29,0.454855195911414,0.545144804088586,16,15,0,4,10603,9898
CardCounter,119,0.45408163265306123,0.5459183673469388,65,63,22,0,10625,9898
CardCounter,22,0.4533106960950764,0.5466893039049237,12,13,51,0,10676,9898
Random,20,0.4542372881355932,0.5457627118644067,11,12,0,47,10676,9945
CardCounter,22,0.45346869712351945,0.5465313028764806,11,11,45,0,10721,9945
CardCounter,79,0.4527027027027027,0.5472972972972973,45,42,28,0,10749,9945
Random,19,0.4536256323777403,0.5463743676222597,11,10,0,5,10749,9950
CardCounter,29,0.45286195286195285,0.5471380471380471,14,16,5,0,10754,9950
CardCounter,19,0.45210084033613446,0.5478991596638656,11,9,1,0,10755,9950
CardCounter,19,0.4513422818791946,0.5486577181208053,9,13,29,0,10784,9950
CardCounter,34,0.45058626465661644,0.5494137353433836,17,19,15,0,10799,9950
CardCounter,13,0.4498327759197324,0.5501672240802675,6,8,7,0,10806,9950
CardCounter,68,0.44908180300500833,0.5509181969949917,36,38,2,0,10808,9950
CardCounter,21,0.4483333333333333,0.5516666666666666,12,11,7,0,10815,9950
CardCounter,80,0.4475873544093178,0.5524126455906821,41,43,40,0,10855,9950
CardCounter,79,0.446843853820598,0.553156146179402,42,42,12,0,10867,9950
Random,39,0.44776119402985076,0.5522388059701493,21,20,0,52,10867,10002
Random,86,0.44867549668874174,0.5513245033112583,46,46,0,5,10867,10007
Random,35,0.44958677685950416,0.5504132231404959,22,17,0,69,10867,10076
CardCounter,23,0.44884488448844884,0.5511551155115512,12,13,13,0,10880,10076
Random,57,0.4497528830313015,0.5502471169686985,35,28,0,4,10880,10080
CardCounter,57,0.44901315789473684,0.5509868421052632,29,29,3,0,10883,10080
Random,163,0.44991789819376027,0.5500821018062397,89,82,0,40,10883,10120
CardCounter,13,0.4491803278688525,0.5508196721311476,8,7,27,0,10910,10120
Random,25,0.4500818330605565,0.5499181669394435,16,13,0,40,10910,10160
Random,112,0.45098039215686275,0.5490196078431373,58,62,0,54,10910,10214
Random,53,0.45187601957585644,0.5481239804241436,30,28,0,115,10910,10329
CardCounter,15,0.4511400651465798,0.5488599348534202,7,8,45,0,10955,10329
CardCounter,10,0.4504065040650406,0.5495934959349593,6,7,8,0,10963,10329
Random,20,0.4512987012987013,0.5487012987012987,10,11,0,34,10963,10363
Random,15,0.4521880064829822,0.5478119935170178,8,7,0,73,10963,10436
CardCounter,13,0.45145631067961167,0.5485436893203883,9,7,54,0,11017,10436
CardCounter,18,0.4507269789983845,0.5492730210016155,12,9,25,0,11042,10436
Random,72,0.45161290322580644,0.5483870967741935,40,38,0,47,11042,10483
CardCounter,24,0.45088566827697263,0.5491143317230274,12,12,18,0,11060,10483
Random,82,0.4517684887459807,0.5482315112540193,45,43,0,27,11060,10510
Random,19,0.45264847512038525,0.5473515248796148,10,9,0,61,11060,10571
Random,64,0.453525641025641,0.5464743589743589,34,32,0,40,11060,10611
CardCounter,16,0.4528,0.5472,8,8,44,0,11104,10611
Random,12,0.4536741214057508,0.5463258785942492,8,6,0,1,11104,10612
CardCounter,12,0.4529505582137161,0.5470494417862839,7,6,42,0,11146,10612
Random,20,0.4538216560509554,0.5461783439490446,11,10,0,52,11146,10664
CardCounter,24,0.45310015898251194,0.5468998410174881,12,13,55,0,11201,10664
CardCounter,11,0.4523809523809524,0.5476190476190477,5,6,32,0,11233,10664
Random,95,0.4532488114104596,0.5467511885895404,51,49,0,55,11233,10719
Random,14,0.4541139240506329,0.5458860759493671,7,7,0,20,11233,10739
Random,43,0.4549763033175355,0.5450236966824644,24,22,0,14,11233,10753
CardCounter,13,0.45425867507886436,0.5457413249211357,8,7,1,0,11234,10753
CardCounter,16,0.45354330708661417,0.5464566929133858,8,10,78,0,11312,10753
Random,42,0.45440251572327045,0.5455974842767296,21,23,0,3,11312,10756
Random,19,0.4552590266875981,0.5447409733124019,11,10,0,11,11312,10767
Random,18,0.4561128526645768,0.5438871473354232,9,9,0,90,11312,10857
Random,57,0.4569640062597809,0.543035993740219,30,28,0,20,11312,10877
Random,36,0.4578125,0.5421875,19,18,0,23,11312,10900
CardCounter,18,0.45709828393135726,0.5429017160686428,10,10,60,0,11372,10900
CardCounter,21,0.45638629283489096,0.543613707165109,10,11,13,0,11385,10900
CardCounter,24,0.4556765163297045,0.5443234836702955,16,13,23,0,11408,10900
CardCounter,9,0.4549689440993789,0.5450310559006211,4,7,21,0,11429,10900
CardCounter,44,0.4542635658914729,0.5457364341085271,22,23,46,0,11475,10900
CardCounter,32,0.4535603715170279,0.5464396284829721,16,16,20,0,11495,10900
Random,55,0.45440494590417313,0.5455950540958269,29,27,0,20,11495,10920
CardCounter,37,0.4537037037037037,0.5462962962962963,20,19,12,0,11507,10920
CardCounter,30,0.4530046224961479,0.5469953775038521,16,17,13,0,11520,10920
Random,66,0.45384615384615384,0.5461538461538461,37,33,0,28,11520,10948
Random,67,0.45468509984639016,0.5453149001536098,36,35,0,40,11520,10988
Random,14,0.455521472392638,0.5444785276073619,7,7,0,19,11520,11007
CardCounter,30,0.4548238897396631,0.5451761102603369,17,16,0,0,11520,11007
CardCounter,13,0.4541284403669725,0.5458715596330275,7,7,7,0,11527,11007
CardCounter,12,0.4534351145038168,0.5465648854961832,8,8,23,0,11550,11007
CardCounter,65,0.4527439024390244,0.5472560975609756,33,36,74,0,11624,11007
CardCounter,18,0.4520547945205479,0.547945205479452,9,9,46,0,11670,11007
Random,72,0.45288753799392095,0.547112462006079,38,40,0,5,11670,11012
CardCounter,56,0.45220030349013657,0.5477996965098634,29,31,51,0,11721,11012
CardCounter,39,0.45151515151515154,0.5484848484848485,19,20,20,0,11741,11012
Random,27,0.4523449319213313,0.5476550680786687,14,13,0,30,11741,11042
Random,46,0.45317220543806647,0.5468277945619335,25,23,0,23,11741,11065
Random,17,0.4539969834087481,0.5460030165912518,10,8,0,20,11741,11085
Random,44,0.45481927710843373,0.5451807228915663,24,25,0,0,11741,11085
Random,37,0.4556390977443609,0.544360902255639,20,19,0,42,11741,11127
CardCounter,21,0.45495495495495497,0.545045045045045,10,15,21,0,11762,11127
Random,91,0.45577211394302847,0.5442278860569715,47,48,0,78,11762,11205
Random,16,0.4565868263473054,0.5434131736526946,10,8,0,58,11762,11263
CardCounter,68,0.45590433482810166,0.5440956651718983,37,37,18,0,11780,11263
CardCounter,25,0.4552238805970149,0.5447761194029851,12,13,28,0,11808,11263
CardCounter,22,0.45454545454545453,0.5454545454545454,12,12,39,0,11847,11263
CardCounter,43,0.4538690476190476,0.5461309523809523,23,24,7,0,11854,11263
CardCounter,36,0.45319465081723626,0.5468053491827637,18,20,46,0,11900,11263
Random,56,0.4540059347181009,0.5459940652818991,29,28,0,40,11900,11303
Random,59,0.45481481481481484,0.5451851851851852,33,31,0,23,11900,11326
CardCounter,13,0.4541420118343195,0.5458579881656804,6,7,24,0,11924,11326
Random,15,0.4549483013293944,0.5450516986706057,9,8,0,41,11924,11367
Random,12,0.4557522123893805,0.5442477876106194,8,6,0,91,11924,11458
CardCounter,16,0.45508100147275404,0.5449189985272459,10,8,27,0,11951,11458
CardCounter,9,0.45441176470588235,0.5455882352941176,4,7,82,0,12033,11458
CardCounter,42,0.45374449339207046,0.5462555066079295,24,21,22,0,12055,11458
CardCounter,63,0.4530791788856305,0.5469208211143695,32,34,6,0,12061,11458
CardCounter,18,0.45241581259150804,0.5475841874084919,9,9,28,0,12089,11458
CardCounter,41,0.4517543859649123,0.5482456140350878,23,21,22,0,12111,11458
Random,79,0.45255474452554745,0.5474452554744526,41,39,0,27,12111,11485
Random,16,0.45335276967930027,0.5466472303206997,10,8,0,65,12111,11550
CardCounter,70,0.45269286754002913,0.5473071324599709,37,36,66,0,12177,11550
CardCounter,9,0.45203488372093026,0.5479651162790697,4,7,7,0,12184,11550
Random,37,0.4528301886792453,0.5471698113207547,20,19,0,37,12184,11587
Random,50,0.45362318840579713,0.5463768115942029,27,28,0,29,12184,11616
CardCounter,32,0.45296671490593343,0.5470332850940666,18,16,54,0,12238,11616
Random,30,0.45375722543352603,0.546242774566474,16,15,0,24,12238,11640
CardCounter,14,0.4531024531024531,0.5468975468975469,8,7,28,0,12266,11640
CardCounter,19,0.45244956772334294,0.547550432276657,9,13,6,0,12272,11640
CardCounter,62,0.45179856115107914,0.5482014388489208,31,32,14,0,12286,11640
CardCounter,25,0.4511494252873563,0.5488505747126436,13,14,31,0,12317,11640
Random,19,0.4519368723098996,0.5480631276901005,10,9,0,40,12317,11680
CardCounter,17,0.4512893982808023,0.5487106017191977,9,9,38,0,12355,11680
CardCounter,20,0.45064377682403434,0.5493562231759657,12,11,29,0,12384,11680
Random,56,0.4514285714285714,0.5485714285714286,29,30,0,19,12384,11699
CardCounter,28,0.4507845934379458,0.5492154065620543,15,15,82,0,12466,11699
CardCounter,11,0.45014245014245013,0.5498575498575499,7,6,36,0,12502,11699
CardCounter,12,0.44950213371266,0.55049786628734,6,6,45,0,12547,11699
CardCounter,15,0.44886363636363635,0.5511363636363636,7,8,42,0,12589,11699
Random,10,0.44964539007092197,0.550354609929078,6,6,0,2,12589,11701
Random,26,0.45042492917847027,0.5495750708215298,13,16,0,1,12589,11702
CardCounter,32,0.4497878359264498,0.5502121640735502,18,18,14,0,12603,11702
Random,14,0.4505649717514124,0.5494350282485876,8,7,0,5,12603,11707
Random,53,0.4513399153737659,0.5486600846262342,27,31,0,29,12603,11736
Random,32,0.45211267605633804,0.547887323943662,16,16,0,45,12603,11781
CardCounter,58,0.45147679324894513,0.5485232067510548,30,31,85,0,12688,11781
Random,42,0.45224719101123595,0.547752808988764,23,24,0,85,12688,11866
Random,11,0.453015427769986,0.5469845722300141,8,5,0,13,12688,11879
Random,62,0.453781512605042,0.5462184873949579,33,33,0,88,12688,11967
CardCounter,12,0.45314685314685316,0.5468531468531469,6,9,15,0,12703,11967
Random,16,0.45391061452513964,0.5460893854748603,10,8,0,27,12703,11994
CardCounter,40,0.45327754532775455,0.5467224546722455,22,22,34,0,12737,11994
Random,26,0.45403899721448465,0.5459610027855153,13,16,0,15,12737,12009
CardCounter,10,0.4534075104311544,0.5465924895688457,6,7,42,0,12779,12009
CardCounter,31,0.4527777777777778,0.5472222222222223,16,17,101,0,12880,12009
CardCounter,16,0.4521497919556172,0.5478502080443828,8,8,42,0,12922,12009
CardCounter,31,0.4515235457063712,0.5484764542936288,17,17,0,0,12922,12009
Random,19,0.45228215767634855,0.5477178423236515,10,9,0,21,12922,12030
CardCounter,39,0.4516574585635359,0.5483425414364641,19,21,60,0,12982,12030
CardCounter,16,0.4510344827586207,0.5489655172413793,8,8,59,0,13041,12030
CardCounter,85,0.45041322314049587,0.5495867768595041,47,45,11,0,13052,12030
Random,29,0.4511691884456671,0.5488308115543329,16,16,0,82,13052,12112
Random,24,0.4519230769230769,0.5480769230769231,12,12,0,31,13052,12143
CardCounter,14,0.4513031550068587,0.5486968449931413,7,9,11,0,13063,12143
Random,14,0.4520547945205479,0.547945205479452,7,7,0,40,13063,12183
Random,63,0.4528043775649795,0.5471956224350205,34,33,0,3,13063,12186
CardCounter,21,0.4521857923497268,0.5478142076502732,10,12,34,0,13097,12186
CardCounter,22,0.451568894952251,0.548431105047749,13,13,31,0,13128,12186
Random,142,0.45231607629427795,0.547683923705722,75,76,0,40,13128,12226
Random,65,0.4530612244897959,0.5469387755102041,34,38,0,30,13128,12256
CardCounter,11,0.452445652173913,0.5475543478260869,5,7,84,0,13212,12256
CardCounter,40,0.451831750339213,0.5481682496607869,21,21,28,0,13240,12256
Random,38,0.45257452574525747,0.5474254742547425,20,23,0,33,13240,12289
CardCounter,18,0.4519621109607578,0.5480378890392422,9,9,94,0,13334,12289
Random,76,0.4527027027027027,0.5472972972972973,42,41,0,101,13334,12390
Random,49,0.4534412955465587,0.5465587044534413,25,27,0,3,13334,12393
CardCounter,13,0.4528301886792453,0.5471698113207547,6,7,67,0,13401,12393
CardCounter,40,0.4522207267833109,0.5477792732166891,22,22,29,0,13430,12393
CardCounter,25,0.45161290322580644,0.5483870967741935,15,13,7,0,13437,12393
Random,33,0.45234899328859063,0.5476510067114094,18,16,0,24,13437,12417
CardCounter,25,0.4517426273458445,0.5482573726541555,13,13,28,0,13465,12417
Random,65,0.4524765729585007,0.5475234270414994,34,33,0,29,13465,12446
Random,30,0.4532085561497326,0.5467914438502673,16,18,0,35,13465,12481
CardCounter,62,0.45260347129506007,0.5473965287049399,33,32,28,0,13493,12481
CardCounter,25,0.452,0.548,12,13,6,0,13499,12481
CardCounter,16,0.45139813581890814,0.5486018641810919,11,8,25,0,13524,12481
CardCounter,29,0.4507978723404255,0.5492021276595744,17,15,4,0,13528,12481
Random,37,0.45152722443559096,0.548472775564409,21,19,0,25,13528,12506
Random,16,0.45225464190981435,0.5477453580901857,8,8,0,7,13528,12513
Random,81,0.45298013245033114,0.5470198675496689,46,43,0,45,13528,12558
Random,60,0.4537037037037037,0.5462962962962963,34,33,0,60,13528,12618
CardCounter,10,0.45310435931307796,0.5468956406869221,5,7,48,0,13576,12618
CardCounter,71,0.4525065963060686,0.5474934036939314,39,37,31,0,13607,12618
Random,15,0.45322793148880103,0.546772068511199,9,7,0,37,13607,12655
CardCounter,123,0.45263157894736844,0.5473684210526316,65,65,14,0,13621,12655
CardCounter,18,0.4520367936925099,0.5479632063074902,9,11,39,0,13660,12655
CardCounter,13,0.45144356955380577,0.5485564304461942,6,7,31,0,13691,12655
CardCounter,14,0.4508519003931848,0.5491480996068152,8,7,36,0,13727,12655
Random,34,0.45157068062827227,0.5484293193717278,18,17,0,48,13727,12703
CardCounter,14,0.45098039215686275,0.5490196078431373,7,7,54,0,13781,12703
CardCounter,29,0.45039164490861616,0.5496083550913838,15,16,36,0,13817,12703
CardCounter,30,0.4498044328552803,0.5501955671447197,15,16,73,0,13890,12703
Random,38,0.4505208333333333,0.5494791666666666,21,22,0,28,13890,12731
CardCounter,26,0.44993498049414826,0.5500650195058517,15,14,0,0,13890,12731
Random,20,0.45064935064935063,0.5493506493506494,11,10,0,24,13890,12755
Random,23,0.45136186770428016,0.5486381322957199,12,11,0,63,13890,12818
CardCounter,17,0.45077720207253885,0.5492227979274611,8,9,48,0,13938,12818
Random,23,0.4514877102199224,0.5485122897800776,15,11,0,109,13938,12927
CardCounter,37,0.4509043927648579,0.5490956072351422,18,22,30,0,13968,12927
Random,25,0.45161290322580644,0.5483870967741935,16,12,0,20,13968,12947
Random,74,0.452319587628866,0.5476804123711341,39,40,0,33,13968,12980
Random,11,0.45302445302445304,0.546975546975547,7,6,0,30,13968,13010
CardCounter,19,0.4524421593830334,0.5475578406169666,9,12,20,0,13988,13010
CardCounter,38,0.45186136071887034,0.5481386392811296,20,20,17,0,14005,13010
Random,58,0.45256410256410257,0.5474358974358975,29,31,0,24,14005,13034
Random,15,0.4532650448143406,0.5467349551856594,8,8,0,44,14005,13078
Random,34,0.4539641943734015,0.5460358056265985,18,17,0,28,14005,13106
CardCounter,34,0.45338441890166026,0.5466155810983397,17,20,2,0,14007,13106
CardCounter,33,0.4528061224489796,0.5471938775510204,17,18,28,0,14035,13106
Random,33,0.4535031847133758,0.5464968152866242,22,18,0,17,14035,13123
CardCounter,23,0.4529262086513995,0.5470737913486005,12,13,41,0,14076,13123
Random,29,0.4536213468869123,0.5463786531130876,16,14,0,50,14076,13173
CardCounter,25,0.4530456852791878,0.5469543147208121,13,13,9,0,14085,13173
CardCounter,26,0.4524714828897338,0.5475285171102662,14,13,29,0,14114,13173
CardCounter,21,0.4518987341772152,0.5481012658227848,10,12,46,0,14160,13173
Random,21,0.4525916561314791,0.5474083438685209,12,11,0,77,14160,13250
Random,10,0.4532828282828283,0.5467171717171717,5,6,0,77,14160,13327
CardCounter,50,0.4527112232030265,0.5472887767969735,27,28,29,0,14189,13327
Random,18,0.4534005037783375,0.5465994962216625,10,9,0,14,14189,13341
Random,25,0.4540880503144654,0.5459119496855346,13,12,0,22,14189,13363
CardCounter,33,0.4535175879396985,0.5464824120603015,18,18,33,0,14222,13363
CardCounter,110,0.45294855708908405,0.5470514429109159,56,60,31,0,14253,13363
CardCounter,17,0.4523809523809524,0.5476190476190477,8,11,12,0,14265,13363
CardCounter,16,0.4518147684605757,0.5481852315394243,8,10,21,0,14286,13363
Random,46,0.4525,0.5475,23,26,0,46,14286,13409
CardCounter,62,0.4519350811485643,0.5480649188514357,35,31,25,0,14311,13409
Random,82,0.45261845386533667,0.5473815461346634,42,46,0,20,14311,13429
CardCounter,44,0.4520547945205479,0.547945205479452,23,24,8,0,14319,13429
CardCounter,27,0.45149253731343286,0.5485074626865671,14,15,0,0,14319,13429
CardCounter,54,0.4509316770186335,0.5490683229813664,30,29,10,0,14329,13429
CardCounter,47,0.45037220843672454,0.5496277915632755,25,28,15,0,14344,13429
CardCounter,34,0.44981412639405205,0.550185873605948,17,17,15,0,14359,13429
CardCounter,41,0.44925742574257427,0.5507425742574258,22,22,38,0,14397,13429
CardCounter,112,0.44870210135970334,0.5512978986402967,62,57,13,0,14410,13429
CardCounter,73,0.44814814814814813,0.5518518518518518,38,40,59,0,14469,13429
Random,29,0.44882860665844637,0.5511713933415536,16,15,0,8,14469,13437
CardCounter,27,0.4482758620689655,0.5517241379310345,14,15,22,0,14491,13437
Random,45,0.4489544895448955,0.5510455104551045,23,25,0,9,14491,13446
CardCounter,13,0.4484029484029484,0.5515970515970516,6,7,71,0,14562,13446
Random,43,0.449079754601227,0.550920245398773,22,22,0,28,14562,13474
Random,28,0.4497549019607843,0.5502450980392157,14,14,0,117,14562,13591
CardCounter,14,0.44920440636474906,0.5507955936352509,8,7,12,0,14574,13591
Random,14,0.44987775061124696,0.5501222493887531,9,9,0,35,14574,13626
Random,33,0.45054945054945056,0.5494505494505495,17,17,0,140,14574,13766
CardCounter,25,0.45,0.55,12,13,45,0,14619,13766
CardCounter,64,0.44945188794153473,0.5505481120584653,35,33,46,0,14665,13766
Random,22,0.45012165450121655,0.5498783454987834,11,11,0,28,14665,13794
CardCounter,40,0.44957472660996356,0.5504252733900364,22,21,9,0,14674,13794
Random,24,0.45024271844660196,0.5497572815533981,13,13,0,8,14674,13802
CardCounter,78,0.4496969696969697,0.5503030303030303,40,43,43,0,14717,13802
CardCounter,25,0.4491525423728814,0.5508474576271186,13,15,21,0,14738,13802
CardCounter,12,0.4486094316807739,0.5513905683192262,7,7,40,0,14778,13802
CardCounter,11,0.44806763285024154,0.5519323671497585,6,10,101,0,14879,13802
Random,41,0.4487334137515078,0.5512665862484921,22,20,0,3,14879,13805
CardCounter,13,0.44819277108433736,0.5518072289156627,6,9,35,0,14914,13805
CardCounter,12,0.44765342960288806,0.5523465703971119,7,6,25,0,14939,13805
CardCounter,39,0.44711538461538464,0.5528846153846154,19,20,26,0,14965,13805
Random,23,0.4477791116446579,0.5522208883553421,15,12,0,41,14965,13846
Random,14,0.44844124700239807,0.5515587529976019,8,7,0,79,14965,13925
Random,75,0.4491017964071856,0.5508982035928144,39,39,0,20,14965,13945
Random,56,0.44976076555023925,0.5502392344497608,30,33,0,15,14965,13960
CardCounter,24,0.44922341696535245,0.5507765830346476,13,15,17,0,14982,13960
Random,120,0.4498806682577566,0.5501193317422435,66,62,0,108,14982,14068
Random,87,0.4505363528009535,0.5494636471990465,45,47,0,59,14982,14127
Random,18,0.4511904761904762,0.5488095238095239,11,9,0,2,14982,14129
Random,15,0.4518430439952438,0.5481569560047562,8,7,0,44,14982,14173
CardCounter,53,0.4513064133016627,0.5486935866983373,29,27,8,0,14990,14173
CardCounter,14,0.45077105575326215,0.5492289442467378,7,7,40,0,15030,14173
CardCounter,19,0.45023696682464454,0.5497630331753555,9,10,35,0,15065,14173
CardCounter,36,0.44970414201183434,0.5502958579881657,18,20,20,0,15085,14173
CardCounter,21,0.4491725768321513,0.5508274231678487,10,11,14,0,15099,14173
Random,40,0.4498229043683589,0.5501770956316411,22,21,0,20,15099,14193
CardCounter,23,0.4492924528301887,0.5507075471698113,12,13,54,0,15153,14193
CardCounter,16,0.44876325088339225,0.5512367491166078,8,9,34,0,15187,14193
CardCounter,79,0.44823529411764707,0.5517647058823529,41,44,30,0,15217,14193
CardCounter,16,0.44770857814336074,0.5522914218566393,10,8,14,0,15231,14193
Random,20,0.44835680751173707,0.5516431924882629,11,10,0,32,15231,14225
Random,31,0.4490035169988277,0.5509964830011723,17,15,0,31,15231,14256
Random,16,0.4496487119437939,0.550351288056206,9,11,0,39,15231,14295
Random,113,0.4502923976608187,0.5497076023391813,61,60,0,6,15231,14301
CardCounter,47,0.4497663551401869,0.5502336448598131,24,24,12,0,15243,14301
CardCounter,44,0.4492415402567094,0.5507584597432905,24,25,40,0,15283,14301
CardCounter,47,0.44871794871794873,0.5512820512820513,25,26,14,0,15297,14301
CardCounter,44,0.4481955762514552,0.5518044237485448,23,24,6,0,15303,14301
CardCounter,13,0.4476744186046512,0.5523255813953488,6,7,31,0,15334,14301
Random,17,0.44831591173054586,0.5516840882694541,10,9,0,19,15334,14320
CardCounter,9,0.44779582366589327,0.5522041763341067,4,7,16,0,15350,14320
Random,13,0.4484356894553882,0.5515643105446119,7,8,0,30,15350,14350
Random,106,0.44907407407407407,0.5509259259259259,57,55,0,36,15350,14386
Random,39,0.44971098265895953,0.5502890173410404,20,19,0,90,15350,14476
CardCounter,13,0.4491916859122402,0.5508083140877598,6,7,32,0,15382,14476
CardCounter,38,0.4486735870818916,0.5513264129181085,20,19,23,0,15405,14476
CardCounter,89,0.44815668202764974,0.5518433179723502,46,48,17,0,15422,14476
Random,23,0.4487917146144994,0.5512082853855006,12,12,0,16,15422,14492
Random,22,0.4494252873563218,0.5505747126436782,12,12,0,0,15422,14492
CardCounter,68,0.4489092996555683,0.5510907003444316,36,36,39,0,15461,14492
CardCounter,29,0.44839449541284404,0.551605504587156,14,15,12,0,15473,14492
Random,43,0.44902634593356244,0.5509736540664376,22,22,0,34,15473,14526
Random,28,0.4496567505720824,0.5503432494279176,15,15,0,20,15473,14546
Random,31,0.4502857142857143,0.5497142857142857,16,15,0,60,15473,14606
CardCounter,23,0.4497716894977169,0.5502283105022832,12,12,81,0,15554,14606
Random,35,0.45039908779931587,0.5496009122006842,21,17,0,12,15554,14618
Random,44,0.4510250569476082,0.5489749430523918,24,23,0,40,15554,14658
CardCounter,22,0.45051194539249145,0.5494880546075085,11,11,53,0,15607,14658
CardCounter,37,0.45,0.55,18,19,16,0,15623,14658
CardCounter,30,0.44948921679909193,0.5505107832009081,15,17,49,0,15672,14658
CardCounter,21,0.4489795918367347,0.5510204081632653,13,13,35,0,15707,14658
CardCounter,62,0.44847112117780297,0.551528878822197,32,36,6,0,15713,14658
Random,94,0.4490950226244344,0.5509049773755657,51,49,0,34,15713,14692
Random,13,0.4497175141242938,0.5502824858757062,7,6,0,33,15713,14725
CardCounter,25,0.4492099322799097,0.5507900677200903,12,15,39,0,15752,14725
Random,29,0.44983089064261556,0.5501691093573844,15,14,0,10,15752,14735
CardCounter,17,0.44932432432432434,0.5506756756756757,8,9,4,0,15756,14735
CardCounter,70,0.44881889763779526,0.5511811023622047,37,39,65,0,15821,14735
Random,48,0.449438202247191,0.550561797752809,26,27,0,2,15821,14737
CardCounter,16,0.4489337822671156,0.5510662177328844,8,10,22,0,15843,14737
CardCounter,27,0.4484304932735426,0.5515695067264574,14,16,20,0,15863,14737
CardCounter,24,0.4479283314669653,0.5520716685330347,12,14,6,0,15869,14737
Random,32,0.44854586129753915,0.5514541387024608,16,16,0,16,15869,14753
CardCounter,12,0.4480446927374302,0.5519553072625698,7,6,55,0,15924,14753
CardCounter,65,0.44754464285714285,0.5524553571428571,34,36,38,0,15962,14753
CardCounter,26,0.44704570791527315,0.5529542920847269,15,15,13,0,15975,14753
CardCounter,7,0.4465478841870824,0.5534521158129176,4,6,170,0,16145,14753
CardCounter,26,0.4460511679644049,0.5539488320355951,13,14,27,0,16172,14753
CardCounter,25,0.44555555555555554,0.5544444444444444,12,13,25,0,16197,14753
CardCounter,26,0.4450610432852386,0.5549389567147613,14,16,7,0,16204,14753
CardCounter,31,0.4445676274944568,0.5554323725055432,18,17,46,0,16250,14753
CardCounter,42,0.4440753045404208,0.5559246954595792,21,23,65,0,16315,14753
Random,64,0.4446902654867257,0.5553097345132744,35,34,0,39,16315,14792
CardCounter,70,0.44419889502762433,0.5558011049723757,36,36,17,0,16332,14792
CardCounter,23,0.44370860927152317,0.5562913907284768,12,12,27,0,16359,14792
CardCounter,36,0.4432194046306505,0.5567805953693495,22,19,5,0,16364,14792
CardCounter,19,0.44273127753303965,0.5572687224669604,10,11,30,0,16394,14792
Random,99,0.44334433443344334,0.5566556655665567,53,52,0,20,16394,14812
CardCounter,137,0.44285714285714284,0.5571428571428572,75,73,38,0,16432,14812
CardCounter,46,0.442371020856202,0.557628979143798,28,24,6,0,16438,14812
CardCounter,25,0.4418859649122807,0.5581140350877193,13,15,8,0,16446,14812
Random,31,0.4424972617743702,0.5575027382256298,18,16,0,43,16446,14855
Random,16,0.4431072210065646,0.5568927789934355,8,9,0,26,16446,14881
CardCounter,18,0.4426229508196721,0.5573770491803278,10,9,15,0,16461,14881
CardCounter,67,0.4421397379912664,0.5578602620087336,36,37,21,0,16482,14881
CardCounter,14,0.4416575790621592,0.5583424209378408,7,9,14,0,16496,14881
Random,16,0.4422657952069717,0.5577342047930284,9,8,0,40,16496,14921
Random,47,0.4428726877040261,0.5571273122959739,25,23,0,42,16496,14963
Random,20,0.4434782608695652,0.5565217391304348,11,12,0,14,16496,14977
CardCounter,18,0.44299674267100975,0.5570032573289903,11,10,38,0,16534,14977
Random,24,0.4436008676789588,0.5563991323210412,12,12,0,0,16534,14977
CardCounter,20,0.4431202600216685,0.5568797399783315,10,10,16,0,16550,14977
Random,64,0.44372294372294374,0.5562770562770563,37,33,0,34,16550,15011
CardCounter,46,0.44324324324324327,0.5567567567567567,24,23,20,0,16570,15011
CardCounter,13,0.4427645788336933,0.5572354211663066,6,7,20,0,16590,15011
Random,45,0.44336569579288027,0.5566343042071198,24,22,0,52,16590,15063
Random,26,0.44396551724137934,0.5560344827586207,13,13,0,96,16590,15159
CardCounter,16,0.4434876210979548,0.5565123789020452,8,9,41,0,16631,15159
CardCounter,19,0.443010752688172,0.556989247311828,12,10,39,0,16670,15159
CardCounter,38,0.44253490870032225,0.5574650912996778,19,23,50,0,16720,15159
Random,14,0.44313304721030045,0.5568669527896996,7,7,0,38,16720,15197
Random,185,0.4437299035369775,0.5562700964630225,100,96,0,0,16720,15197
CardCounter,17,0.44325481798715205,0.556745182012848,8,9,9,0,16729,15197
CardCounter,32,0.44278074866310163,0.5572192513368984,17,18,10,0,16739,15197
Random,26,0.44337606837606836,0.5566239316239316,14,13,0,16,16739,15213
CardCounter,148,0.4429028815368196,0.5570971184631803,78,80,17,0,16756,15213
Random,32,0.44349680170575695,0.5565031982942431,18,16,0,29,16756,15242
CardCounter,68,0.443024494142705,0.556975505857295,36,35,37,0,16793,15242
Random,22,0.44361702127659575,0.5563829787234043,13,11,0,22,16793,15264
CardCounter,30,0.44314558979808716,0.5568544102019128,17,18,20,0,16813,15264
CardCounter,57,0.4426751592356688,0.5573248407643312,30,33,38,0,16851,15264
Random,16,0.4432661717921527,0.5567338282078473,9,8,0,111,16851,15375
CardCounter,7,0.4427966101694915,0.5572033898305084,3,7,5,0,16856,15375
Random,15,0.4433862433862434,0.5566137566137566,10,8,0,46,16856,15421
Random,26,0.4439746300211416,0.5560253699788583,13,13,0,37,16856,15458
Random,35,0.44456177402323127,0.5554382259767687,20,17,0,42,16856,15500
CardCounter,13,0.4440928270042194,0.5559071729957806,8,7,29,0,16885,15500
CardCounter,20,0.44362486828240255,0.5563751317175974,12,10,56,0,16941,15500
CardCounter,17,0.4431578947368421,0.5568421052631579,10,11,3,0,16944,15500
CardCounter,24,0.4426919032597266,0.5573080967402734,13,12,16,0,16960,15500
CardCounter,25,0.4422268907563025,0.5577731092436975,13,15,16,0,16976,15500
CardCounter,26,0.44176285414480587,0.5582371458551941,13,14,13,0,16989,15500
CardCounter,45,0.4412997903563941,0.5587002096436059,23,26,26,0,17015,15500
CardCounter,26,0.4408376963350785,0.5591623036649215,13,13,39,0,17054,15500
Random,24,0.44142259414225943,0.5585774058577406,12,12,0,43,17054,15543
CardCounter,26,0.44096133751306166,0.5590386624869383,15,14,4,0,17058,15543
Random,24,0.44154488517745305,0.558455114822547,12,12,0,32,17058,15575
Random,45,0.4421272158498436,0.5578727841501564,24,22,0,86,17058,15661
Random,40,0.4427083333333333,0.5572916666666666,20,21,0,9,17058,15670
Random,97,0.4432882414151925,0.5567117585848075,53,50,0,54,17058,15724
CardCounter,23,0.44282744282744285,0.5571725571725572,11,14,25,0,17083,15724
Random,59,0.4434060228452752,0.5565939771547248,34,29,0,85,17083,15809
Random,90,0.44398340248962653,0.5560165975103735,50,46,0,23,17083,15832
CardCounter,38,0.44352331606217615,0.5564766839378238,22,20,106,0,17189,15832
CardCounter,19,0.44306418219461696,0.556935817805383,10,10,32,0,17221,15832
CardCounter,42,0.44260599793174765,0.5573940020682523,21,24,12,0,17233,15832
CardCounter,7,0.44214876033057854,0.5578512396694215,3,7,34,0,17267,15832
CardCounter,18,0.44169246646026833,0.5583075335397317,10,9,48,0,17315,15832
CardCounter,17,0.44123711340206184,0.5587628865979382,8,11,32,0,17347,15832
Random,83,0.44181256436663235,0.5581874356333677,44,45,0,3,17347,15835
Random,22,0.44238683127572015,0.5576131687242798,11,11,0,20,17347,15855
Random,39,0.44295991778006166,0.5570400822199383,23,21,0,18,17347,15873
CardCounter,19,0.44250513347022585,0.5574948665297741,10,11,13,0,17360,15873
Random,9,0.4430769230769231,0.556923076923077,7,4,0,92,17360,15965
CardCounter,31,0.4426229508196721,0.5573770491803278,16,16,3,0,17363,15965
Random,25,0.44319344933469806,0.5568065506653019,14,12,0,50,17363,16015
CardCounter,11,0.4427402862985685,0.5572597137014315,5,7,61,0,17424,16015
CardCounter,8,0.44228804902962204,0.557711950970378,4,8,20,0,17444,16015
Random,30,0.44285714285714284,0.5571428571428572,15,17,0,3,17444,16018
Random,13,0.4434250764525994,0.5565749235474006,7,6,0,0,17444,16018
CardCounter,15,0.4429735234215886,0.5570264765784114,7,8,21,0,17465,16018
Random,55,0.44354018311291965,0.5564598168870803,28,27,0,8,17465,16026
CardCounter,65,0.44308943089430897,0.556910569105691,33,35,14,0,17479,16026
CardCounter,10,0.44263959390862945,0.5573604060913706,6,6,31,0,17510,16026
Random,12,0.4432048681541582,0.5567951318458418,6,7,0,112,17510,16138
Random,33,0.44376899696048633,0.5562310030395137,18,16,0,20,17510,16158
Random,14,0.444331983805668,0.555668016194332,9,7,0,1,17510,16159
Random,71,0.4448938321536906,0.5551061678463094,36,39,0,4,17510,16163
Random,34,0.44545454545454544,0.5545454545454546,17,20,0,20,17510,16183
CardCounter,12,0.4450050454086781,0.5549949545913219,6,7,95,0,17605,16183
CardCounter,13,0.44455645161290325,0.5554435483870968,6,7,34,0,17639,16183
Random,27,0.44511581067472306,0.5548841893252769,15,13,0,65,17639,16248
Random,30,0.44567404426559354,0.5543259557344065,16,15,0,56,17639,16304
CardCounter,20,0.4452261306532663,0.5547738693467337,11,10,51,0,17690,16304
Random,18,0.4457831325301205,0.5542168674698795,11,9,0,18,17690,16322
Random,51,0.4463390170511535,0.5536609829488466,27,26,0,21,17690,16343
Random,74,0.4468937875751503,0.5531062124248497,40,41,0,141,17690,16484
CardCounter,134,0.44644644644644643,0.5535535535535535,72,70,48,0,17738,16484
Random,46,0.447,0.553,25,26,0,43,17738,16527
CardCounter,70,0.44655344655344653,0.5534465534465535,38,38,53,0,17791,16527
Random,44,0.4471057884231537,0.5528942115768463,23,26,0,15,17791,16542
Random,39,0.4476570289132602,0.5523429710867398,21,20,0,20,17791,16562
Random,26,0.448207171314741,0.5517928286852589,13,15,0,54,17791,16616
CardCounter,12,0.44776119402985076,0.5522388059701493,6,8,52,0,17843,16616
Random,14,0.44831013916500995,0.55168986083499,8,8,0,55,17843,16671
CardCounter,18,0.44786494538232374,0.5521350546176763,9,10,42,0,17885,16671
Random,26,0.44841269841269843,0.5515873015873016,14,13,0,46,17885,16717
CardCounter,60,0.44796828543111994,0.5520317145688801,34,31,22,0,17907,16717
Random,70,0.4485148514851485,0.5514851485148515,36,38,0,40,17907,16757
CardCounter,12,0.44807121661721067,0.5519287833827893,6,7,54,0,17961,16757
CardCounter,85,0.44762845849802374,0.5523715415019763,46,45,18,0,17979,16757
CardCounter,68,0.4471865745310958,0.5528134254689042,36,37,8,0,17987,16757
CardCounter,23,0.4467455621301775,0.5532544378698225,14,12,34,0,18021,16757
Random,79,0.44729064039408867,0.5527093596059113,40,41,0,6,18021,16763
CardCounter,63,0.4468503937007874,0.5531496062992126,32,33,20,0,18041,16763
CardCounter,14,0.4464110127826942,0.5535889872173058,7,7,17,0,18058,16763
CardCounter,53,0.44597249508840864,0.5540275049115914,28,29,76,0,18134,16763
CardCounter,70,0.44553483807654565,0.5544651619234544,40,36,5,0,18139,16763
CardCounter,19,0.44509803921568625,0.5549019607843138,9,11,8,0,18147,16763
CardCounter,20,0.4446620959843291,0.555337904015671,10,11,53,0,18200,16763
CardCounter,13,0.44422700587084146,0.5557729941291585,6,8,27,0,18227,16763
Random,39,0.4447702834799609,0.555229716520039,20,21,0,88,18227,16851
CardCounter,99,0.4443359375,0.5556640625,56,52,15,0,18242,16851
CardCounter,46,0.44390243902439025,0.5560975609756098,25,24,22,0,18264,16851
Random,14,0.4444444444444444,0.5555555555555556,7,7,0,43,18264,16894
CardCounter,16,0.44401168451801365,0.5559883154819864,10,8,12,0,18276,16894
CardCounter,37,0.44357976653696496,0.556420233463035,19,20,49,0,18325,16894
CardCounter,14,0.44314868804664725,0.5568513119533528,7,7,43,0,18368,16894
CardCounter,65,0.44271844660194176,0.5572815533980583,33,35,38,0,18406,16894
CardCounter,48,0.4422890397672163,0.5577109602327837,26,26,8,0,18414,16894
CardCounter,15,0.4418604651162791,0.5581395348837209,8,8,45,0,18459,16894
CardCounter,20,0.441432720232333,0.558567279767667,10,10,49,0,18508,16894
CardCounter,17,0.4410058027079304,0.5589941972920697,8,10,1,0,18509,16894
CardCounter,12,0.4405797101449275,0.5594202898550724,6,8,5,0,18514,16894
CardCounter,29,0.44015444015444016,0.5598455598455598,15,16,30,0,18544,16894
Random,15,0.4406943105110897,0.5593056894889104,8,8,0,54,18544,16948
CardCounter,81,0.44026974951830444,0.5597302504816956,44,43,25,0,18569,16948
Random,15,0.4408084696823869,0.559191530317613,10,8,0,2,18569,16950
Random,20,0.44134615384615383,0.5586538461538462,11,11,0,24,18569,16974
Random,33,0.44188280499519694,0.5581171950048031,19,16,0,9,18569,16983
CardCounter,67,0.44145873320537427,0.5585412667946257,34,37,10,0,18579,16983
Random,45,0.4419942473633749,0.5580057526366251,23,22,0,43,18579,17026
Random,58,0.4425287356321839,0.5574712643678161,30,30,0,45,18579,17071
CardCounter,22,0.4421052631578947,0.5578947368421052,11,11,20,0,18599,17071
Random,20,0.44263862332695986,0.5573613766730402,11,10,0,27,18599,17098
Random,83,0.44317096466093603,0.556829035339064,43,42,0,45,18599,17143
Random,82,0.4437022900763359,0.5562977099236641,45,41,0,30,18599,17173
CardCounter,40,0.4432793136320305,0.5567206863679695,22,22,5,0,18604,17173
CardCounter,53,0.44285714285714284,0.5571428571428572,29,28,8,0,18612,17173
Random,27,0.4433872502378687,0.5566127497621313,16,13,0,44,18612,17217
CardCounter,27,0.4429657794676806,0.5570342205323194,13,16,12,0,18624,17217
CardCounter,48,0.44254510921177587,0.5574548907882241,25,27,4,0,18628,17217
CardCounter,13,0.44212523719165087,0.5578747628083491,7,7,11,0,18639,17217
CardCounter,14,0.44170616113744077,0.5582938388625592,7,7,7,0,18646,17217
CardCounter,77,0.4412878787878788,0.5587121212121212,40,43,52,0,18698,17217
Random,33,0.44181646168401134,0.5581835383159887,18,17,0,29,18698,17246
CardCounter,25,0.44139886578449905,0.558601134215501,13,15,22,0,18720,17246
CardCounter,152,0.4409820585457979,0.559017941454202,80,81,30,0,18750,17246
CardCounter,15,0.44056603773584907,0.559433962264151,7,8,44,0,18794,17246
CardCounter,50,0.44015080113100846,0.5598491988689915,29,25,14,0,18808,17246
CardCounter,115,0.4397363465160075,0.5602636534839924,63,60,25,0,18833,17246
Random,47,0.44026340545625586,0.5597365945437441,26,24,0,45,18833,17291
CardCounter,13,0.4398496240601504,0.5601503759398496,6,7,56,0,18889,17291
CardCounter,20,0.4394366197183099,0.5605633802816902,11,10,10,0,18899,17291
CardCounter,17,0.43902439024390244,0.5609756097560976,8,9,49,0,18948,17291
CardCounter,14,0.4386129334582943,0.5613870665417057,7,7,71,0,19019,17291
CardCounter,15,0.43820224719101125,0.5617977528089888,8,9,87,0,19106,17291
Random,17,0.43872778297474274,0.5612722170252572,9,10,0,20,19106,17311
Random,32,0.4392523364485981,0.5607476635514018,17,18,0,11,19106,17322
CardCounter,28,0.4388422035480859,0.5611577964519141,15,15,75,0,19181,17322
Random,80,0.439365671641791,0.5606343283582089,43,44,0,28,19181,17350
Random,15,0.43988816402609504,0.5601118359739049,10,8,0,52,19181,17402
Random,48,0.4404096834264432,0.5595903165735568,25,25,0,66,19181,17468
Random,15,0.4409302325581395,0.5590697674418604,8,9,0,114,19181,17582
CardCounter,39,0.44052044609665425,0.5594795539033457,19,23,37,0,19218,17582
Random,17,0.44103992571959144,0.5589600742804085,9,8,0,21,19218,17603
Random,24,0.44155844155844154,0.5584415584415584,14,13,0,20,19218,17623
Random,23,0.44207599629286376,0.5579240037071362,13,13,0,28,19218,17651
Random,54,0.4425925925925926,0.5574074074074075,31,27,0,26,19218,17677
CardCounter,26,0.4421831637372803,0.5578168362627197,13,13,3,0,19221,17677
Random,14,0.44269870609981515,0.5573012939001848,7,7,0,24,19221,17701
Random,11,0.44321329639889195,0.556786703601108,7,8,0,6,19221,17707
CardCounter,21,0.44280442804428044,0.5571955719557196,10,13,46,0,19267,17707
Random,51,0.4433179723502304,0.5566820276497696,30,26,0,26,19267,17733
CardCounter,23,0.4429097605893186,0.5570902394106814,11,12,16,0,19283,17733
Random,29,0.44342226310947563,0.5565777368905244,15,16,0,40,19283,17773
Random,12,0.44393382352941174,0.5560661764705882,6,7,0,57,19283,17830
CardCounter,14,0.44352617079889806,0.5564738292011019,7,7,97,0,19380,17830
CardCounter,70,0.44311926605504587,0.5568807339449541,40,38,4,0,19384,17830
CardCounter,58,0.4427131072410632,0.5572868927589367,29,33,26,0,19410,17830
Random,22,0.4432234432234432,0.5567765567765568,11,11,0,34,19410,17864
Random,21,0.44373284537968893,0.5562671546203111,15,11,0,48,19410,17912
Random,18,0.44424131627056673,0.5557586837294333,12,9,0,20,19410,17932
CardCounter,48,0.4438356164383562,0.5561643835616439,25,24,28,0,19438,17932
CardCounter,11,0.44343065693430656,0.5565693430656934,5,6,47,0,19485,17932
CardCounter,70,0.4430264357338195,0.5569735642661805,37,38,26,0,19511,17932
CardCounter,27,0.4426229508196721,0.5573770491803278,15,15,14,0,19525,17932
Random,49,0.44313011828935395,0.556869881710646,25,28,0,28,19525,17960
CardCounter,37,0.44272727272727275,0.5572727272727273,19,19,27,0,19552,17960
CardCounter,30,0.44232515894641233,0.5576748410535877,15,15,17,0,19569,17960
CardCounter,33,0.4419237749546279,0.558076225045372,16,19,51,0,19620,17960
CardCounter,32,0.44152311876699907,0.5584768812330009,18,17,52,0,19672,17960
Random,19,0.4420289855072464,0.5579710144927537,10,10,0,27,19672,17987
Random,23,0.4425339366515837,0.5574660633484163,12,11,0,51,19672,18038
Random,26,0.4430379746835443,0.5569620253164557,14,13,0,25,19672,18063
Random,37,0.44354110207768743,0.5564588979223125,23,19,0,17,19672,18080
Random,54,0.44404332129963897,0.555956678700361,29,28,0,41,19672,18121
Random,23,0.44454463480613166,0.5554553651938684,12,11,0,42,19672,18163
Random,58,0.44504504504504505,0.554954954954955,29,33,0,29,19672,18192
CardCounter,74,0.4446444644464446,0.5553555355535553,39,39,8,0,19680,18192
CardCounter,95,0.4442446043165468,0.5557553956834532,49,52,48,0,19728,18192
CardCounter,18,0.44384546271338726,0.5561545372866128,9,9,5,0,19733,18192
Random,42,0.44434470377019747,0.5556552962298025,22,22,0,25,19733,18217
CardCounter,60,0.4439461883408072,0.5560538116591929,36,32,16,0,19749,18217
Random,92,0.4444444444444444,0.5555555555555556,46,50,0,8,19749,18225
Random,27,0.4449418084153984,0.5550581915846016,17,13,0,20,19749,18245
Random,70,0.44543828264758495,0.554561717352415,36,38,0,16,19749,18261
Random,15,0.4459338695263628,0.5540661304736372,9,7,0,9,19749,18270
CardCounter,45,0.4455357142857143,0.5544642857142857,23,28,51,0,19800,18270
CardCounter,62,0.4451382694023194,0.5548617305976806,33,34,25,0,19825,18270
Random,38,0.44563279857397503,0.5543672014260249,22,21,0,20,19825,18290
CardCounter,16,0.4452359750667854,0.5547640249332146,8,10,26,0,19851,18290
Random,24,0.445729537366548,0.5542704626334519,14,13,0,51,19851,18341
CardCounter,12,0.44533333333333336,0.5546666666666666,6,8,13,0,19864,18341
CardCounter,11,0.44493783303730017,0.5550621669626998,6,7,18,0,19882,18341
Random,41,0.4454303460514641,0.554569653948536,22,21,0,45,19882,18386
CardCounter,43,0.4450354609929078,0.5549645390070922,23,22,20,0,19902,18386
Random,17,0.4455270150575731,0.5544729849424269,9,8,0,41,19902,18427
CardCounter,11,0.4451327433628319,0.5548672566371682,7,7,7,0,19909,18427
CardCounter,20,0.4447391688770999,0.5552608311229,10,11,6,0,19915,18427
CardCounter,27,0.44434628975265017,0.5556537102473498,14,14,20,0,19935,18427
Random,27,0.44483671668137686,0.5551632833186231,16,13,0,28,19935,18455
CardCounter,29,0.4444444444444444,0.5555555555555556,15,17,12,0,19947,18455
Random,9,0.44493392070484583,0.5550660792951542,7,4,0,19,19947,18474
Random,52,0.4454225352112676,0.5545774647887324,27,26,0,61,19947,18535
CardCounter,12,0.4450307827616535,0.5549692172383466,7,6,125,0,20072,18535
CardCounter,21,0.4446397188049209,0.5553602811950791,10,11,19,0,20091,18535
Random,27,0.44512730465320455,0.5548726953467954,16,13,0,35,20091,18570
CardCounter,17,0.44473684210526315,0.5552631578947368,8,10,17,0,20108,18570
Random,21,0.44522348816827345,0.5547765118317266,14,12,0,17,20108,18587
Random,16,0.4457092819614711,0.5542907180385289,8,11,0,8,20108,18595
CardCounter,42,0.4453193350831146,0.5546806649168854,23,21,38,0,20146,18595
CardCounter,79,0.44493006993006995,0.5550699300699301,42,43,39,0,20185,18595
CardCounter,14,0.44454148471615723,0.5554585152838428,8,7,124,0,20309,18595
Random,16,0.44502617801047123,0.5549738219895288,8,9,0,33,20309,18628
CardCounter,40,0.44463818657367044,0.5553618134263295,20,22,73,0,20382,18628
CardCounter,37,0.4442508710801394,0.5557491289198606,18,21,9,0,20391,18628
CardCounter,24,0.44386422976501305,0.556135770234987,15,13,5,0,20396,18628
CardCounter,13,0.4434782608695652,0.5565217391304348,7,7,76,0,20472,18628
CardCounter,46,0.4430929626411816,0.5569070373588184,23,27,3,0,20475,18628
Random,14,0.4435763888888889,0.5564236111111112,7,7,0,126,20475,18754
CardCounter,34,0.44319167389418906,0.5568083261058109,17,19,20,0,20495,18754
CardCounter,19,0.44280762564991333,0.5571923743500866,10,11,13,0,20508,18754
Random,23,0.4432900432900433,0.5567099567099567,12,11,0,9,20508,18763
CardCounter,101,0.4429065743944637,0.5570934256055363,54,52,23,0,20531,18763
CardCounter,36,0.442523768366465,0.557476231633535,20,21,69,0,20600,18763
CardCounter,37,0.4421416234887737,0.5578583765112263,19,19,44,0,20644,18763
Random,27,0.4426229508196721,0.5573770491803278,15,13,0,113,20644,18876
Random,24,0.44310344827586207,0.5568965517241379,12,13,0,31,20644,18907
CardCounter,32,0.4427217915590009,0.5572782084409992,18,19,16,0,20660,18907
CardCounter,129,0.4423407917383821,0.5576592082616179,66,72,22,0,20682,18907
CardCounter,22,0.4419604471195185,0.5580395528804815,11,11,48,0,20730,18907
CardCounter,39,0.4415807560137457,0.5584192439862543,21,20,3,0,20733,18907
CardCounter,62,0.4412017167381974,0.5587982832618026,34,32,22,0,20755,18907
CardCounter,63,0.44082332761578047,0.5591766723842195,34,34,39,0,20794,18907
CardCounter,48,0.44044558697514996,0.5595544130248501,28,25,18,0,20812,18907
CardCounter,57,0.4400684931506849,0.559931506849315,28,31,38,0,20850,18907
CardCounter,86,0.43969204448246363,0.5603079555175363,45,45,31,0,20881,18907
Random,52,0.44017094017094016,0.5598290598290598,27,26,0,16,20881,18923
Random,17,0.4406490179333903,0.5593509820666097,9,8,0,8,20881,18931
CardCounter,25,0.4402730375426621,0.5597269624573379,12,14,27,0,20908,18931
Random,17,0.44075021312872975,0.5592497868712702,11,8,0,224,20908,19155
Random,16,0.44122657580919933,0.5587734241908007,8,10,0,152,20908,19307
CardCounter,24,0.4408510638297872,0.5591489361702128,13,15,27,0,20935,19307
CardCounter,43,0.44047619047619047,0.5595238095238095,22,23,35,0,20970,19307
CardCounter,114,0.44010195412064573,0.5598980458793543,60,62,31,0,21001,19307
Random,30,0.4405772495755518,0.5594227504244482,18,15,0,31,21001,19338
Random,21,0.4410517387616624,0.5589482612383376,12,11,0,43,21001,19381
Random,36,0.44152542372881354,0.5584745762711865,21,19,0,27,21001,19408
CardCounter,78,0.441151566469094,0.558848433530906,42,43,14,0,21015,19408
CardCounter,7,0.4407783417935702,0.5592216582064298,4,6,82,0,21097,19408
CardCounter,14,0.44040574809805577,0.5595942519019442,9,7,27,0,21124,19408
CardCounter,21,0.44003378378378377,0.5599662162162162,10,13,39,0,21163,19408
Random,27,0.44050632911392407,0.5594936708860759,21,14,0,10,21163,19418
Random,40,0.44097807757166946,0.5590219224283305,20,22,0,52,21163,19470
Random,33,0.44144903117101936,0.5585509688289806,19,16,0,62,21163,19532
Random,14,0.44191919191919193,0.5580808080808081,7,7,0,16,21163,19548
CardCounter,34,0.4415475189234651,0.5584524810765349,17,20,0,0,21163,19548
Random,14,0.44201680672268906,0.5579831932773109,8,7,0,79,21163,19627
CardCounter,28,0.44164567590260284,0.5583543240973972,15,14,6,0,21169,19627
Random,44,0.44211409395973156,0.5578859060402684,23,22,0,44,21169,19671
Random,49,0.4425817267393127,0.5574182732606874,27,25,0,24,21169,19695
Random,20,0.44304857621440535,0.5569514237855946,13,10,0,27,21169,19722
CardCounter,26,0.4426778242677824,0.5573221757322175,13,15,10,0,21179,19722
Random,52,0.4431438127090301,0.5568561872909699,26,26,0,27,21179,19749
Random,83,0.44360902255639095,0.556390977443609,43,45,0,43,21179,19792
Random,52,0.44407345575959933,0.5559265442404007,29,27,0,30,21179,19822
Random,13,0.4445371142618849,0.5554628857381151,8,6,0,134,21179,19956
Random,24,0.445,0.555,13,12,0,30,21179,19986
CardCounter,46,0.4446294754371357,0.5553705245628643,24,24,43,0,21222,19986
CardCounter,105,0.4442595673876872,0.5557404326123128,57,59,34,0,21256,19986
Random,17,0.44472152950955945,0.5552784704904405,9,9,0,17,21256,20003
CardCounter,11,0.44435215946843853,0.5556478405315615,7,6,71,0,21327,20003
CardCounter,14,0.44398340248962653,0.5560165975103735,7,7,5,0,21332,20003
Random,106,0.4444444444444444,0.5555555555555556,58,55,0,60,21332,20063
CardCounter,24,0.44407622203811103,0.555923777961889,13,13,26,0,21358,20063
CardCounter,19,0.44370860927152317,0.5562913907284768,9,10,122,0,21480,20063
CardCounter,20,0.44334160463192723,0.5566583953680728,13,10,14,0,21494,20063
CardCounter,39,0.44297520661157025,0.5570247933884298,20,21,19,0,21513,20063
CardCounter,26,0.4426094137076796,0.5573905862923204,15,13,9,0,21522,20063
CardCounter,12,0.44224422442244227,0.5577557755775577,6,6,20,0,21542,20063
Random,19,0.4427040395713108,0.5572959604286892,10,10,0,71,21542,20134
CardCounter,47,0.44233937397034595,0.557660626029654,27,24,7,0,21549,20134
CardCounter,24,0.4419753086419753,0.5580246913580247,14,12,42,0,21591,20134
Random,34,0.44243421052631576,0.5575657894736842,19,17,0,1,21591,20135
CardCounter,12,0.44207066557107644,0.5579293344289236,6,7,29,0,21620,20135
CardCounter,33,0.44170771756978655,0.5582922824302134,17,20,26,0,21646,20135
CardCounter,18,0.4413453650533224,0.5586546349466776,9,10,8,0,21654,20135
Random,12,0.4418032786885246,0.5581967213114755,7,6,0,23,21654,20158
Random,15,0.44226044226044225,0.5577395577395577,9,7,0,35,21654,20193
CardCounter,23,0.44189852700491,0.55810147299509,11,12,23,0,21677,20193
Random,21,0.4423548650858545,0.5576451349141456,11,10,0,62,21677,20255
Random,70,0.44281045751633985,0.5571895424836601,36,37,0,40,21677,20295
Random,35,0.44326530612244897,0.556734693877551,20,18,0,32,21677,20327
Random,26,0.4437194127243067,0.5562805872756933,14,13,0,32,21677,20359
CardCounter,24,0.44335778321108393,0.556642216788916,12,15,8,0,21685,20359
CardCounter,19,0.44299674267100975,0.5570032573289903,10,11,42,0,21727,20359
Random,13,0.4434499593165175,0.5565500406834825,7,6,0,64,21727,20423
Random,10,0.44390243902439025,0.5560975609756098,7,6,0,28,21727,20451
CardCounter,34,0.4435418359057677,0.5564581640942323,18,18,10,0,21737,20451
CardCounter,19,0.4431818181818182,0.5568181818181818,10,10,6,0,21743,20451
CardCounter,42,0.44282238442822386,0.5571776155717761,25,22,17,0,21760,20451
Random,12,0.44327390599675853,0.5567260940032415,7,6,0,21,21760,20472
CardCounter,18,0.44291497975708505,0.557085020242915,13,9,32,0,21792,20472
CardCounter,11,0.4425566343042071,0.5574433656957929,7,6,72,0,21864,20472
CardCounter,14,0.4421988682295877,0.5578011317704122,7,7,9,0,21873,20472
CardCounter,13,0.4418416801292407,0.5581583198707593,6,7,88,0,21961,20472
Random,9,0.44229217110573044,0.5577078288942696,7,4,0,28,21961,20500
Random,26,0.442741935483871,0.557258064516129,14,13,0,46,21961,20546
CardCounter,10,0.44238517324738114,0.5576148267526189,5,7,38,0,21999,20546
CardCounter,27,0.4420289855072464,0.5579710144927537,15,14,78,0,22077,20546
Random,31,0.4424778761061947,0.5575221238938053,17,15,0,12,22077,20558
Random,30,0.4429260450160772,0.5570739549839229,17,15,0,12,22077,20570
Random,47,0.4433734939759036,0.5566265060240964,25,27,0,20,22077,20590
CardCounter,39,0.44301765650080255,0.5569823434991974,21,20,44,0,22121,20590
CardCounter,16,0.44266238973536487,0.5573376102646351,9,9,15,0,22136,20590
Random,42,0.44310897435897434,0.5568910256410257,24,21,0,5,22136,20595
Random,19,0.4435548438751001,0.5564451561248999,10,9,0,80,22136,20675
CardCounter,89,0.4432,0.5568,44,50,14,0,22150,20675
CardCounter,98,0.442845723421263,0.5571542765787371,56,49,9,0,22159,20675
Random,38,0.44329073482428116,0.5567092651757188,21,22,0,25,22159,20700
Random,13,0.44373503591380686,0.5562649640861931,9,6,0,1,22159,20701
CardCounter,15,0.4433811802232855,0.5566188197767146,7,9,3,0,22162,20701
Random,15,0.4438247011952191,0.5561752988047809,8,9,0,27,22162,20728
CardCounter,85,0.4434713375796178,0.5565286624203821,44,46,18,0,22180,20728
CardCounter,36,0.44311853619729513,0.5568814638027049,23,19,26,0,22206,20728
Random,50,0.4435612082670906,0.5564387917329093,26,26,0,8,22206,20736
CardCounter,20,0.443208895949166,0.556791104050834,11,11,5,0,22211,20736
CardCounter,13,0.44285714285714284,0.5571428571428572,6,7,56,0,22267,20736
CardCounter,44,0.4425059476605868,0.5574940523394132,22,24,17,0,22284,20736
Random,38,0.4429477020602219,0.5570522979397782,20,19,0,1,22284,20737
Random,17,0.4433887569279493,0.5566112430720507,9,8,0,52,22284,20789
Random,16,0.4438291139240506,0.5561708860759493,8,9,0,52,22284,20841
CardCounter,16,0.4434782608695652,0.5565217391304348,8,9,12,0,22296,20841
CardCounter,39,0.4431279620853081,0.556872037914692,20,22,6,0,22302,20841
CardCounter,62,0.44277821625887925,0.5572217837411207,33,33,7,0,22309,20841
CardCounter,25,0.44242902208201895,0.557570977917981,14,13,58,0,22367,20841
CardCounter,18,0.44208037825059104,0.557919621749409,9,10,29,0,22396,20841
Random,82,0.44251968503937006,0.5574803149606299,43,46,0,33,22396,20874
CardCounter,58,0.44217151848937847,0.5578284815106216,31,31,46,0,22442,20874
CardCounter,68,0.4418238993710692,0.5581761006289309,35,38,0,0,22442,20874
CardCounter,26,0.44147682639434405,0.558523173605656,13,13,26,0,22468,20874
CardCounter,39,0.4411302982731554,0.5588697017268446,21,21,2,0,22470,20874
CardCounter,22,0.4407843137254902,0.5592156862745098,11,13,42,0,22512,20874
Random,24,0.44122257053291536,0.5587774294670846,14,12,0,11,22512,20885
Random,23,0.44166014095536416,0.5583398590446359,12,11,0,53,22512,20938
Random,88,0.44209702660406885,0.5579029733959311,46,46,0,32,22512,20970
CardCounter,30,0.44175136825645034,0.5582486317435497,19,16,13,0,22525,20970
Random,32,0.4421875,0.5578125,17,16,0,51,22525,21021
Random,51,0.4426229508196721,0.5573770491803278,26,27,0,10,22525,21031
Random,14,0.44305772230889234,0.5569422776911076,9,8,0,20,22525,21051
CardCounter,20,0.4427123928293063,0.5572876071706937,11,10,27,0,22552,21051
CardCounter,85,0.4423676012461059,0.557632398753894,45,47,38,0,22590,21051
CardCounter,24,0.44202334630350193,0.5579766536964981,14,12,20,0,22610,21051
Random,20,0.44245723172628304,0.557542768273717,11,11,0,44,22610,21095
Random,47,0.4428904428904429,0.5571095571095571,28,24,0,6,22610,21101
CardCounter,23,0.44254658385093165,0.5574534161490683,14,14,9,0,22619,21101
CardCounter,24,0.4422032583397983,0.5577967416602017,12,12,52,0,22671,21101
Random,18,0.44263565891472867,0.5573643410852713,11,9,0,40,22671,21141
CardCounter,16,0.44229279628195195,0.557707203718048,8,10,40,0,22711,21141
CardCounter,13,0.4419504643962848,0.5580495356037152,8,9,50,0,22761,21141
Random,13,0.4423820572312452,0.5576179427687549,11,6,0,30,22761,21171
CardCounter,59,0.4420401854714065,0.5579598145285936,30,33,49,0,22810,21171
CardCounter,12,0.4416988416988417,0.5583011583011583,7,8,54,0,22864,21171
CardCounter,11,0.44135802469135804,0.558641975308642,5,7,45,0,22909,21171
CardCounter,18,0.441017733230532,0.558982266769468,11,9,66,0,22975,21171
CardCounter,51,0.4406779661016949,0.559322033898305,28,27,60,0,23035,21171
CardCounter,18,0.4403387220939184,0.5596612779060816,11,9,0,0,23035,21171
Random,60,0.44076923076923075,0.5592307692307692,30,30,0,101,23035,21272
CardCounter,16,0.4404304381245196,0.5595695618754803,9,9,64,0,23099,21272
Random,86,0.44086021505376344,0.5591397849462365,47,45,0,31,23099,21303
CardCounter,30,0.4405218726016884,0.5594781273983116,16,15,23,0,23122,21303
CardCounter,21,0.4401840490797546,0.5598159509202454,10,12,40,0,23162,21303
Random,51,0.44061302681992337,0.5593869731800766,29,26,0,9,23162,21312
CardCounter,19,0.44027565084226644,0.5597243491577335,9,10,43,0,23205,21312
CardCounter,40,0.43993879112471307,0.5600612088752869,21,20,8,0,23213,21312
CardCounter,51,0.4396024464831804,0.5603975535168195,29,27,63,0,23276,21312
CardCounter,68,0.439266615737204,0.5607333842627961,34,35,9,0,23285,21312
CardCounter,33,0.4389312977099237,0.5610687022900763,16,18,24,0,23309,21312
Random,61,0.43935926773455375,0.5606407322654462,33,32,0,37,23309,21349
Random,26,0.43978658536585363,0.5602134146341463,13,13,0,24,23309,21373
CardCounter,14,0.43945163747143945,0.5605483625285606,7,7,75,0,23384,21373
CardCounter,17,0.439117199391172,0.560882800608828,8,9,28,0,23412,21373
CardCounter,26,0.4387832699619772,0.5612167300380229,13,15,27,0,23439,21373
CardCounter,22,0.43844984802431614,0.5615501519756839,11,13,12,0,23451,21373
Random,31,0.43887623386484437,0.5611237661351557,16,15,0,22,23451,21395
CardCounter,35,0.4385432473444613,0.5614567526555387,18,20,26,0,23477,21395
CardCounter,42,0.4382107657316149,0.5617892342683851,23,21,1,0,23478,21395
CardCounter,41,0.43787878787878787,0.5621212121212121,22,22,10,0,23488,21395
Random,69,0.43830431491294475,0.5616956850870553,39,37,0,49,23488,21444
Random,22,0.43872919818456885,0.5612708018154312,11,12,0,43,23488,21487
Random,79,0.43915343915343913,0.5608465608465608,44,40,0,21,23488,21508
CardCounter,35,0.438821752265861,0.5611782477341389,17,19,41,0,23529,21508
Random,21,0.43924528301886795,0.5607547169811321,12,10,0,108,23529,21616
CardCounter,19,0.43891402714932126,0.5610859728506787,11,10,40,0,23569,21616
CardCounter,56,0.4385832705350414,0.5614167294649586,30,30,28,0,23597,21616
CardCounter,13,0.4382530120481928,0.5617469879518072,7,7,37,0,23634,21616
Random,15,0.43867569601203915,0.5613243039879608,8,7,0,21,23634,21637
CardCounter,57,0.43834586466165415,0.5616541353383459,31,31,18,0,23652,21637
CardCounter,14,0.4380165289256198,0.5619834710743802,7,7,34,0,23686,21637
Random,46,0.43843843843843844,0.5615615615615616,23,26,0,15,23686,21652
Random,79,0.43885971492873216,0.5611402850712678,43,42,0,11,23686,21663
CardCounter,9,0.43853073463268366,0.5614692653673163,5,6,167,0,23853,21663
Random,29,0.4389513108614232,0.5610486891385768,16,15,0,28,23853,21691
CardCounter,13,0.43862275449101795,0.561377245508982,6,7,76,0,23929,21691
CardCounter,20,0.43829468960359014,0.5617053103964099,13,10,8,0,23937,21691
CardCounter,11,0.43796711509715996,0.5620328849028401,8,7,16,0,23953,21691
Random,29,0.438386855862584,0.561613144137416,15,14,0,8,23953,21699
CardCounter,25,0.4380597014925373,0.5619402985074626,16,13,9,0,23962,21699
Random,23,0.43847874720357943,0.5615212527964206,12,12,0,20,23962,21719
Random,14,0.43889716840536513,0.5611028315946349,7,9,0,32,23962,21751
CardCounter,30,0.43857036485480266,0.5614296351451973,15,16,100,0,24062,21751
CardCounter,25,0.4382440476190476,0.5617559523809523,12,15,3,0,24065,21751
Random,39,0.43866171003717475,0.5613382899628253,23,19,0,11,24065,21762
Random,26,0.4390787518573551,0.5609212481426449,14,15,0,82,24065,21844
Random,47,0.4394951744617669,0.5605048255382331,24,24,0,2,24065,21846
CardCounter,47,0.4391691394658754,0.5608308605341247,24,27,28,0,24093,21846
Random,23,0.4395848776871757,0.5604151223128243,15,11,0,0,24093,21846
Random,50,0.44,0.56,26,26,0,20,24093,21866
CardCounter,72,0.4396743153219837,0.5603256846780162,37,40,49,0,24142,21866
Random,76,0.4400887573964497,0.5599112426035503,40,42,0,18,24142,21884
Random,41,0.44050258684405025,0.5594974131559497,23,23,0,10,24142,21894
Random,50,0.44091580502215655,0.5590841949778435,25,28,0,3,24142,21897
Random,21,0.44132841328413286,0.5586715867158671,11,11,0,180,24142,22077
Random,60,0.441740412979351,0.5582595870206489,36,32,0,10,24142,22087
CardCounter,16,0.44141488577745025,0.5585851142225498,9,8,54,0,24196,22087
Random,26,0.4418262150220913,0.5581737849779087,13,13,0,8,24196,22095
Random,69,0.44223693892568067,0.5577630610743194,39,38,0,0,24196,22095
CardCounter,45,0.44191176470588234,0.5580882352941177,24,25,7,0,24203,22095
Random,97,0.4423218221895665,0.5576781778104335,50,49,0,20,24203,22115
CardCounter,15,0.4419970631424376,0.5580029368575624,7,8,13,0,24216,22115
Random,23,0.44240645634629494,0.5575935436537051,13,11,0,47,24216,22162
CardCounter,13,0.44208211143695014,0.5579178885630498,6,7,12,0,24228,22162
CardCounter,14,0.44175824175824174,0.5582417582417583,7,7,8,0,24236,22162
CardCounter,35,0.44143484626647145,0.5585651537335286,18,19,6,0,24242,22162
Random,67,0.44184345281638626,0.5581565471836137,37,35,0,6,24242,22168
CardCounter,63,0.4415204678362573,0.5584795321637427,33,35,30,0,24272,22168
CardCounter,16,0.4411979547114682,0.5588020452885317,8,9,6,0,24278,22168
Random,62,0.4416058394160584,0.5583941605839416,33,32,0,47,24278,22215
CardCounter,60,0.4412837345003647,0.5587162654996353,31,30,57,0,24335,22215
Random,36,0.44169096209912534,0.5583090379008746,19,18,0,75,24335,22290
CardCounter,32,0.44136926438455937,0.5586307356154406,18,17,32,0,24367,22290
Random,14,0.4417758369723435,0.5582241630276564,9,7,0,54,24367,22344
Random,11,0.4421818181818182,0.5578181818181818,7,5,0,5,24367,22349
CardCounter,17,0.4418604651162791,0.5581395348837209,8,11,40,0,24407,22349
Random,29,0.4422657952069717,0.5577342047930284,16,15,0,1,24407,22350
CardCounter,33,0.44194484760522496,0.558055152394775,19,18,18,0,24425,22350
CardCounter,204,0.4416243654822335,0.5583756345177665,108,107,22,0,24447,22350
CardCounter,25,0.44130434782608696,0.558695652173913,12,16,11,0,24458,22350
CardCounter,14,0.44098479362780596,0.559015206372194,7,7,17,0,24475,22350
Random,14,0.44138929088277856,0.5586107091172214,7,9,0,23,24475,22373
CardCounter,22,0.4410701373825018,0.5589298626174982,11,13,14,0,24489,22373
CardCounter,47,0.4407514450867052,0.5592485549132948,24,25,23,0,24512,22373
CardCounter,20,0.4404332129963899,0.5595667870036101,12,12,24,0,24536,22373
CardCounter,13,0.4401154401154401,0.5598845598845599,6,7,13,0,24549,22373
Random,49,0.4405191059841384,0.5594808940158615,26,24,0,20,24549,22393
CardCounter,13,0.44020172910662825,0.5597982708933718,7,7,10,0,24559,22393
CardCounter,22,0.4398848092152628,0.5601151907847373,13,11,63,0,24622,22393
CardCounter,17,0.439568345323741,0.560431654676259,8,11,24,0,24646,22393
CardCounter,16,0.4392523364485981,0.5607476635514018,9,9,8,0,24654,22393
CardCounter,55,0.4389367816091954,0.5610632183908046,28,31,64,0,24718,22393
CardCounter,20,0.43862167982771,0.5613783201722901,10,10,18,0,24736,22393
Random,28,0.43902439024390244,0.5609756097560976,15,15,0,52,24736,22445
Random,11,0.43942652329749105,0.560573476702509,6,5,0,114,24736,22559
CardCounter,13,0.4391117478510029,0.5608882521489972,6,9,59,0,24795,22559
CardCounter,71,0.43879742304939157,0.5612025769506085,39,36,56,0,24851,22559
CardCounter,45,0.438483547925608,0.5615164520743919,22,26,30,0,24881,22559
Random,15,0.4388849177984274,0.5611150822015726,10,7,0,71,24881,22630
CardCounter,11,0.43857142857142856,0.5614285714285714,7,6,64,0,24945,22630
CardCounter,30,0.4382583868665239,0.561741613133476,17,18,14,0,24959,22630
CardCounter,19,0.43794579172610554,0.5620542082738944,9,12,39,0,24998,22630
Random,21,0.4383464005702067,0.5616535994297933,12,12,0,22,24998,22652
Random,32,0.43874643874643876,0.5612535612535613,18,17,0,23,24998,22675
Random,29,0.4391459074733096,0.5608540925266904,15,14,0,20,24998,22695
Random,44,0.4395448079658606,0.5604551920341394,23,22,0,32,24998,22727
CardCounter,12,0.43923240938166314,0.5607675906183369,6,8,28,0,25026,22727
Random,26,0.4396306818181818,0.5603693181818182,15,15,0,24,25026,22751
CardCounter,36,0.43931866572036904,0.560681334279631,20,21,8,0,25034,22751
Random,84,0.4397163120567376,0.5602836879432624,44,45,0,121,25034,22872
CardCounter,20,0.4394046775336641,0.5605953224663359,12,12,29,0,25063,22872
CardCounter,13,0.43909348441926344,0.5609065155807366,6,7,55,0,25118,22872
CardCounter,20,0.43878273177636234,0.5612172682236376,10,11,22,0,25140,22872
CardCounter,33,0.43847241867043846,0.5615275813295615,16,19,26,0,25166,22872
Random,33,0.43886925795053006,0.56113074204947,19,16,0,27,25166,22899
Random,62,0.4392655367231638,0.5607344632768362,34,32,0,51,25166,22950
CardCounter,14,0.4389555398729711,0.5610444601270289,7,7,18,0,25184,22950
CardCounter,35,0.4386459802538787,0.5613540197461213,17,19,5,0,25189,22950
Random,85,0.4390415785764623,0.5609584214235377,49,44,0,20,25189,22970
Random,24,0.4394366197183099,0.5605633802816902,12,14,0,34,25189,23004
Random,71,0.4398311048557354,0.5601688951442646,38,39,0,68,25189,23072
Random,66,0.44022503516174405,0.559774964838256,34,36,0,23,25189,23095
Random,49,0.44061841180604355,0.5593815881939564,26,26,0,117,25189,23212
Random,32,0.4410112359550562,0.5589887640449438,18,17,0,2,25189,23214
Random,65,0.4414035087719298,0.5585964912280702,35,34,0,45,25189,23259
Random,28,0.4417952314165498,0.5582047685834503,15,16,0,10,25189,23269
Random,69,0.4421864050455501,0.5578135949544499,37,34,0,72,25189,23341
Random,38,0.4425770308123249,0.5574229691876751,21,19,0,52,25189,23393
Random,29,0.4429671098670399,0.5570328901329601,17,14,0,40,25189,23433
Random,32,0.4433566433566434,0.5566433566433566,17,18,0,35,25189,23468
Random,33,0.4437456324248777,0.5562543675751223,18,16,0,39,25189,23507
CardCounter,41,0.44343575418994413,0.5565642458100558,21,24,34,0,25223,23507
Random,13,0.4438241451500349,0.5561758548499651,7,6,0,55,25223,23562
CardCounter,85,0.4435146443514644,0.5564853556485355,44,45,2,0,25225,23562
Random,37,0.44390243902439025,0.5560975609756098,19,20,0,9,25225,23571
CardCounter,55,0.4435933147632312,0.5564066852367688,27,31,14,0,25239,23571
CardCounter,10,0.44328462073764785,0.5567153792623522,5,7,5,0,25244,23571
Random,14,0.44367176634214184,0.5563282336578581,8,7,0,41,25244,23612
CardCounter,48,0.443363446838082,0.556636553161918,26,25,7,0,25251,23612
Random,18,0.44375,0.55625,9,11,0,20,25251,23632
Random,61,0.4441360166551006,0.5558639833448994,36,30,0,28,25251,23660
CardCounter,17,0.44382801664355065,0.5561719833564494,8,9,60,0,25311,23660
CardCounter,28,0.4435204435204435,0.5564795564795565,15,14,40,0,25351,23660
CardCounter,33,0.44321329639889195,0.556786703601108,16,17,26,0,25377,23660
CardCounter,26,0.4429065743944637,0.5570934256055363,13,13,27,0,25404,23660
CardCounter,17,0.4426002766251729,0.5573997233748271,9,11,24,0,25428,23660
CardCounter,37,0.44229440221147204,0.557705597788528,21,18,3,0,25431,23660
CardCounter,11,0.4419889502762431,0.5580110497237569,5,7,57,0,25488,23660
CardCounter,88,0.4416839199447895,0.5583160800552105,47,47,16,0,25504,23660
CardCounter,43,0.4413793103448276,0.5586206896551724,22,22,49,0,25553,23660
Random,45,0.44176430048242593,0.5582356995175741,26,23,0,51,25553,23711
Random,24,0.44214876033057854,0.5578512396694215,13,12,0,62,25553,23773
Random,49,0.4425326909841707,0.5574673090158293,27,27,0,33,25553,23806
CardCounter,13,0.44222833562585967,0.5577716643741403,7,7,18,0,25571,23806
Random,31,0.44261168384879723,0.5573883161512028,16,15,0,21,25571,23827
Random,22,0.4429945054945055,0.5570054945054945,12,13,0,49,25571,23876
CardCounter,118,0.4426904598490048,0.5573095401509952,59,67,6,0,25577,23876
Random,40,0.4430727023319616,0.5569272976680384,20,20,0,50,25577,23926
CardCounter,34,0.4427690198766278,0.5572309801233721,17,20,0,0,25577,23926
Random,38,0.44315068493150683,0.5568493150684931,19,22,0,1,25577,23927
Random,79,0.44353182751540043,0.5564681724845996,41,43,0,47,25577,23974
CardCounter,13,0.4432284541723666,0.5567715458276333,8,7,10,0,25587,23974
CardCounter,32,0.4429254955570745,0.5570745044429255,19,16,38,0,25625,23974
CardCounter,141,0.4426229508196721,0.5573770491803278,73,81,2,0,25627,23974
Random,31,0.44300341296928325,0.5569965870307167,17,15,0,7,25627,23981
Random,10,0.4433833560709413,0.5566166439290586,7,5,0,176,25627,24157
CardCounter,56,0.4430811179277437,0.5569188820722563,28,30,84,0,25711,24157
CardCounter,19,0.4427792915531335,0.5572207084468664,12,13,17,0,25728,24157
CardCounter,20,0.4424778761061947,0.5575221238938053,10,10,34,0,25762,24157
Random,74,0.44285714285714284,0.5571428571428572,42,38,0,28,25762,24185
CardCounter,64,0.44255608429639703,0.557443915703603,34,34,44,0,25806,24185
Random,32,0.4429347826086957,0.5570652173913043,17,16,0,8,25806,24193
CardCounter,44,0.4426340801086219,0.5573659198913782,25,25,27,0,25833,24193
Random,24,0.44301221166892807,0.5569877883310719,12,13,0,28,25833,24221
CardCounter,86,0.4427118644067797,0.5572881355932203,45,46,18,0,25851,24221
CardCounter,47,0.4424119241192412,0.5575880758807588,23,25,13,0,25864,24221
CardCounter,18,0.44211238997968855,0.5578876100203114,10,9,21,0,25885,24221
CardCounter,35,0.44181326116373476,0.5581867388362652,18,20,17,0,25902,24221
CardCounter,14,0.4415145368492224,0.5584854631507775,7,7,76,0,25978,24221
Random,34,0.4418918918918919,0.5581081081081081,19,17,0,33,25978,24254
CardCounter,66,0.4415935178933153,0.5584064821066846,35,36,20,0,25998,24254
CardCounter,33,0.44129554655870445,0.5587044534412956,19,18,66,0,26064,24254
CardCounter,12,0.44099797707349964,0.5590020229265004,6,6,53,0,26117,24254
Random,92,0.4413746630727763,0.5586253369272237,48,50,0,27,26117,24281
Random,29,0.4417508417508417,0.5582491582491582,16,14,0,46,26117,24327
CardCounter,35,0.4414535666218035,0.5585464333781965,18,19,7,0,26124,24327
CardCounter,76,0.44115669132481505,0.558843308675185,44,40,16,0,26140,24327
CardCounter,21,0.44086021505376344,0.5591397849462365,10,11,24,0,26164,24327
CardCounter,16,0.44056413700470115,0.5594358629952989,9,8,80,0,26244,24327
Random,54,0.44093959731543625,0.5590604026845638,31,27,0,18,26244,24345
CardCounter,22,0.44064386317907445,0.5593561368209256,13,12,31,0,26275,24345
Random,24,0.4410187667560322,0.5589812332439679,12,12,0,28,26275,24373
CardCounter,30,0.4407233757535164,0.5592766242464836,15,15,29,0,26304,24373
CardCounter,101,0.4404283801874163,0.5595716198125836,54,55,14,0,26318,24373
Random,15,0.4408026755852843,0.5591973244147157,8,7,0,35,26318,24408
CardCounter,13,0.4405080213903743,0.5594919786096256,6,8,13,0,26331,24408
Random,23,0.4408817635270541,0.5591182364729459,14,12,0,35,26331,24443
CardCounter,23,0.44058744993324434,0.5594125500667557,13,13,24,0,26355,24443
Random,27,0.4409606404269513,0.5590393595730487,15,16,0,51,26355,24494
Random,50,0.44133333333333336,0.5586666666666666,29,27,0,42,26355,24536
CardCounter,88,0.44103930712858097,0.558960692871419,46,47,33,0,26388,24536
Random,40,0.4414114513981358,0.5585885486018641,21,21,0,20,26388,24556
CardCounter,12,0.4411177644710579,0.5588822355289421,9,7,63,0,26451,24556
CardCounter,15,0.4408244680851064,0.5591755319148937,9,8,77,0,26528,24556
CardCounter,16,0.440531561461794,0.5594684385382059,8,8,29,0,26557,24556
CardCounter,13,0.4402390438247012,0.5597609561752988,7,7,33,0,26590,24556
Random,25,0.44061048440610484,0.5593895155938952,13,13,0,28,26590,24584
CardCounter,19,0.4403183023872679,0.5596816976127321,11,10,29,0,26619,24584
CardCounter,16,0.44002650762094103,0.559973492379059,9,8,60,0,26679,24584
CardCounter,35,0.43973509933774835,0.5602649006622517,17,20,14,0,26693,24584
Random,91,0.4401058901389808,0.5598941098610192,51,46,0,49,26693,24633
CardCounter,17,0.4398148148148148,0.5601851851851852,8,9,86,0,26779,24633
CardCounter,18,0.43952412425644416,0.5604758757435558,9,12,29,0,26808,24633
CardCounter,21,0.4392338177014531,0.5607661822985469,11,11,42,0,26850,24633
CardCounter,14,0.4389438943894389,0.5610561056105611,8,7,12,0,26862,24633
CardCounter,29,0.4386543535620053,0.5613456464379947,16,15,53,0,26915,24633
CardCounter,54,0.43836519446275546,0.5616348055372445,29,29,10,0,26925,24633
Random,28,0.43873517786561267,0.5612648221343873,17,15,0,38,26925,24671
CardCounter,24,0.43844634628044765,0.5615536537195523,12,12,55,0,26980,24671
Random,42,0.4388157894736842,0.5611842105263158,25,22,0,14,26980,24685
Random,33,0.43918474687705455,0.5608152531229454,17,21,0,18,26980,24703
Random,26,0.4395532194480946,0.5604467805519053,13,14,0,5,26980,24708
CardCounter,15,0.4392646093237032,0.5607353906762967,8,7,47,0,27027,24708
Random,12,0.43963254593175854,0.5603674540682415,7,6,0,23,27027,24731
Random,33,0.44,0.56,17,20,0,20,27027,24751
Random,16,0.44036697247706424,0.5596330275229358,8,8,0,6,27027,24757
Random,33,0.4407334643091028,0.5592665356908972,17,17,0,55,27027,24812
CardCounter,11,0.44044502617801046,0.5595549738219895,6,8,18,0,27045,24812
CardCounter,52,0.44015696533682147,0.5598430346631785,29,27,66,0,27111,24812
CardCounter,29,0.4398692810457516,0.5601307189542484,15,15,9,0,27120,24812
CardCounter,10,0.4395819725669497,0.5604180274330502,5,7,34,0,27154,24812
CardCounter,15,0.43929503916449086,0.5607049608355091,8,8,27,0,27181,24812
CardCounter,22,0.4390084801043705,0.5609915198956295,15,12,16,0,27197,24812
CardCounter,15,0.438722294654498,0.5612777053455019,7,8,76,0,27273,24812
CardCounter,22,0.43843648208469055,0.5615635179153095,11,11,12,0,27285,24812
CardCounter,19,0.4381510416666667,0.5618489583333334,9,11,29,0,27314,24812
Random,31,0.4385165907612232,0.5614834092387768,18,15,0,37,27314,24849
CardCounter,11,0.43823146944083224,0.5617685305591678,5,7,41,0,27355,24849
Random,107,0.43859649122807015,0.5614035087719298,57,60,0,20,27355,24869
CardCounter,41,0.4383116883116883,0.5616883116883117,21,24,16,0,27371,24869
Random,9,0.43867618429591176,0.5613238157040883,7,7,0,47,27371,24916
CardCounter,19,0.4383916990920882,0.5616083009079118,9,10,13,0,27384,24916
Random,33,0.4387556707712249,0.5612443292287751,18,18,0,20,27384,24936
CardCounter,57,0.4384715025906736,0.5615284974093264,30,34,14,0,27398,24936
CardCounter,38,0.4381877022653722,0.5618122977346278,21,19,12,0,27410,24936
Random,48,0.4385510996119017,0.5614489003880984,27,24,0,49,27410,24985
Random,93,0.43891402714932126,0.5610859728506787,50,49,0,5,27410,24990
CardCounter,29,0.43863049095607237,0.5613695090439277,16,16,20,0,27430,24990
CardCounter,24,0.43834732085216266,0.5616526791478373,12,12,36,0,27466,24990
Random,30,0.43870967741935485,0.5612903225806452,17,15,0,48,27466,25038
Random,35,0.43907156673114117,0.5609284332688588,18,17,0,50,27466,25088
Random,22,0.43943298969072164,0.5605670103092784,11,11,0,42,27466,25130
CardCounter,14,0.43915003219575016,0.5608499678042499,7,7,20,0,27486,25130
CardCounter,11,0.43886743886743884,0.5611325611325612,5,6,62,0,27548,25130
CardCounter,18,0.43858520900321546,0.5614147909967846,10,11,37,0,27585,25130
Random,28,0.4389460154241645,0.5610539845758354,15,14,0,42,27585,25172
CardCounter,28,0.4386640976236352,0.5613359023763648,14,16,0,0,27585,25172
CardCounter,51,0.43838254172015406,0.561617458279846,26,27,52,0,27637,25172
CardCounter,32,0.4381013470173188,0.5618986529826812,18,16,84,0,27721,25172
Random,102,0.43846153846153846,0.5615384615384615,53,54,0,71,27721,25243
Random,33,0.438821268417681,0.561178731582319,17,17,0,40,27721,25283
Random,56,0.43918053777208704,0.5608194622279129,28,32,0,26,27721,25309
Random,101,0.43953934740882916,0.5604606525911708,56,51,0,21,27721,25330
CardCounter,35,0.43925831202046034,0.5607416879795396,18,18,8,0,27729,25330
CardCounter,42,0.4389776357827476,0.5610223642172524,22,24,51,0,27780,25330
CardCounter,13,0.4386973180076628,0.5613026819923371,7,7,0,0,27780,25330
Random,47,0.4390555201021059,0.5609444798978941,26,23,0,41,27780,25371
CardCounter,23,0.4387755102040816,0.5612244897959183,13,14,28,0,27808,25371
CardCounter,28,0.43849585723390694,0.5615041427660931,14,15,7,0,27815,25371
CardCounter,15,0.43821656050955415,0.5617834394904458,8,8,91,0,27906,25371
Random,17,0.4385741565881604,0.5614258434118395,9,8,0,131,27906,25502
Random,22,0.4389312977099237,0.5610687022900763,13,14,0,22,27906,25524
Random,19,0.4392879847425302,0.5607120152574698,10,10,0,23,27906,25547
CardCounter,13,0.43900889453621345,0.5609911054637865,6,7,43,0,27949,25547
Random,9,0.43936507936507935,0.5606349206349206,7,4,0,49,27949,25596
CardCounter,27,0.43908629441624364,0.5609137055837563,13,16,4,0,27953,25596
CardCounter,26,0.43880786303107167,0.5611921369689283,13,17,39,0,27992,25596
Random,92,0.4391634980988593,0.5608365019011406,51,48,0,45,27992,25641
CardCounter,8,0.4388853704876504,0.5611146295123496,4,7,73,0,28065,25641
CardCounter,27,0.43860759493670887,0.5613924050632911,14,14,35,0,28100,25641
CardCounter,16,0.43833017077798864,0.5616698292220114,10,8,14,0,28114,25641
Random,40,0.438685208596713,0.561314791403287,20,20,0,41,28114,25682
CardCounter,26,0.43840808591282376,0.5615919140871762,14,14,15,0,28129,25682
Random,26,0.43876262626262624,0.5612373737373737,13,13,0,44,28129,25726
CardCounter,28,0.4384858044164038,0.5615141955835962,19,14,13,0,28142,25726
CardCounter,13,0.4382093316519546,0.5617906683480454,6,7,134,0,28276,25726
Random,59,0.43856332703213613,0.5614366729678639,32,29,0,68,28276,25794
CardCounter,21,0.43828715365239296,0.5617128463476071,11,11,56,0,28332,25794
CardCounter,14,0.4380113278791693,0.5619886721208307,7,7,101,0,28433,25794
Random,26,0.43836477987421385,0.5616352201257861,15,13,0,48,28433,25842
CardCounter,74,0.4380892520427404,0.5619107479572596,39,39,56,0,28489,25842
Random,22,0.43844221105527637,0.5615577889447236,12,13,0,4,28489,25846
CardCounter,106,0.4381669805398619,0.5618330194601381,58,55,23,0,28512,25846
CardCounter,65,0.437892095357591,0.562107904642409,36,33,29,0,28541,25846
Random,93,0.43824451410658305,0.561755485893417,50,49,0,38,28541,25884
CardCounter,59,0.43796992481203006,0.5620300751879699,33,34,0,0,28541,25884
Random,15,0.43832185347526614,0.5616781465247339,8,7,0,40,28541,25924
CardCounter,17,0.4380475594493116,0.5619524405506884,9,9,23,0,28564,25924
Random,39,0.43839899937460913,0.5616010006253909,22,19,0,20,28564,25944
Random,46,0.43875,0.56125,26,23,0,50,28564,25994
CardCounter,40,0.438475952529669,0.561524047470331,22,21,34,0,28598,25994
Random,26,0.4388264669163546,0.5611735330836455,15,13,0,1,28598,25995
CardCounter,18,0.438552713661884,0.561447286338116,9,11,4,0,28602,25995
CardCounter,27,0.4382793017456359,0.5617206982543641,13,16,27,0,28629,25995
CardCounter,40,0.43800623052959503,0.561993769470405,21,21,1,0,28630,25995
Random,70,0.4383561643835616,0.5616438356164384,36,39,0,31,28630,26026
Random,13,0.4387056627255756,0.5612943372744243,7,6,0,104,28630,26130
CardCounter,13,0.43843283582089554,0.5615671641791045,8,7,8,0,28638,26130
CardCounter,92,0.4381603480422623,0.5618396519577378,47,50,46,0,28684,26130
Random,62,0.43850931677018634,0.5614906832298137,35,32,0,14,28684,26144
Random,11,0.4388578522656735,0.5611421477343265,6,6,0,76,28684,26220
Random,16,0.4392059553349876,0.5607940446650124,8,8,0,15,28684,26235
Random,27,0.43955362678239307,0.5604463732176069,15,13,0,40,28684,26275
Random,20,0.4399008674101611,0.5600991325898389,10,11,0,55,28684,26330
CardCounter,20,0.43962848297213625,0.5603715170278638,11,10,32,0,28716,26330
Random,22,0.4399752475247525,0.5600247524752475,11,11,0,30,28716,26360
CardCounter,20,0.4397031539888683,0.5602968460111317,13,10,17,0,28733,26360
Random,38,0.4400494437577256,0.5599505562422744,19,19,0,27,28733,26387
CardCounter,96,0.4397776405188388,0.5602223594811612,49,50,11,0,28744,26387
Random,18,0.44012345679012344,0.5598765432098766,9,9,0,18,28744,26405
Random,71,0.4404688463911166,0.5595311536088834,42,36,0,9,28744,26414
CardCounter,151,0.4401972872996301,0.55980271270037,80,80,9,0,28753,26414
Random,75,0.4405422057917437,0.5594577942082564,41,38,0,32,28753,26446
Random,126,0.4408866995073892,0.5591133004926109,68,65,0,62,28753,26508
Random,35,0.4412307692307692,0.5587692307692308,18,19,0,5,28753,26513
CardCounter,21,0.44095940959409596,0.559040590405904,11,12,25,0,28778,26513
Random,49,0.44130301167793484,0.5586969883220652,25,26,0,49,28778,26562
Random,14,0.4416461916461916,0.5583538083538083,7,9,0,68,28778,26630
CardCounter,22,0.44137507673419274,0.5586249232658073,12,11,37,0,28815,26630
Random,24,0.44171779141104295,0.558282208588957,13,14,0,22,28815,26652
Random,57,0.44206008583690987,0.5579399141630901,33,29,0,4,28815,26656
Random,50,0.4424019607843137,0.5575980392156863,26,27,0,16,28815,26672
Random,15,0.4427434170238824,0.5572565829761176,10,8,0,173,28815,26845
Random,70,0.4430844553243574,0.5569155446756426,36,37,0,30,28815,26875
CardCounter,42,0.44281345565749236,0.5571865443425077,23,21,20,0,28835,26875
CardCounter,13,0.44254278728606355,0.5574572127139364,6,7,33,0,28868,26875
Random,11,0.4428833231521075,0.5571166768478925,6,5,0,85,28868,26960
CardCounter,79,0.4426129426129426,0.5573870573870574,41,42,14,0,28882,26960
CardCounter,24,0.4423428920073215,0.5576571079926784,12,13,11,0,28893,26960
CardCounter,15,0.4420731707317073,0.5579268292682927,8,9,47,0,28940,26960
CardCounter,78,0.4418037781840341,0.5581962218159658,40,39,63,0,29003,26960
CardCounter,15,0.4415347137637028,0.5584652862362972,10,8,42,0,29045,26960
Random,25,0.4418746195982958,0.5581253804017042,14,12,0,58,29045,27018
CardCounter,9,0.4416058394160584,0.5583941605839416,4,7,13,0,29058,27018
Random,35,0.4419452887537994,0.5580547112462007,21,18,0,21,29058,27039
CardCounter,13,0.4416767922235723,0.5583232077764277,7,7,131,0,29189,27039
CardCounter,56,0.4414086217364906,0.5585913782635095,32,30,0,0,29189,27039
CardCounter,21,0.4411407766990291,0.5588592233009708,10,11,31,0,29220,27039
CardCounter,14,0.4408732565191025,0.5591267434808975,8,7,29,0,29249,27039
CardCounter,37,0.4406060606060606,0.5593939393939394,19,21,7,0,29256,27039
Random,23,0.4409448818897638,0.5590551181102362,13,11,0,16,29256,27055
CardCounter,131,0.4406779661016949,0.559322033898305,71,70,15,0,29271,27055
CardCounter,22,0.44041137326073804,0.5595886267392619,11,11,41,0,29312,27055
CardCounter,19,0.44014510278113667,0.5598548972188634,11,12,20,0,29332,27055
CardCounter,44,0.4398791540785498,0.5601208459214502,22,22,33,0,29365,27055
CardCounter,27,0.4396135265700483,0.5603864734299517,13,15,3,0,29368,27055
CardCounter,42,0.43934821967410986,0.5606517803258901,24,24,26,0,29394,27055
CardCounter,39,0.4390832328106152,0.5609167671893848,21,22,10,0,29404,27055
Random,37,0.4394213381555154,0.5605786618444847,20,19,0,14,29404,27069
Random,46,0.4397590361445783,0.5602409638554217,26,26,0,25,29404,27094
Random,33,0.44009632751354605,0.5599036724864539,21,16,0,165,29404,27259
CardCounter,21,0.4398315282791817,0.5601684717208183,11,11,34,0,29438,27259
CardCounter,22,0.4395670475045099,0.5604329524954901,11,11,33,0,29471,27259
CardCounter,23,0.43930288461538464,0.5606971153846154,11,14,23,0,29494,27259
CardCounter,18,0.439039039039039,0.5609609609609609,10,9,58,0,29552,27259
Random,28,0.43937575030012005,0.56062424969988,17,14,0,5,29552,27264
Random,27,0.4397120575884823,0.5602879424115177,14,13,0,48,29552,27312
CardCounter,17,0.4394484412470024,0.5605515587529976,11,9,29,0,29581,27312
CardCounter,36,0.43918514080287596,0.560814859197124,21,21,16,0,29597,27312
CardCounter,23,0.43892215568862275,0.5610778443113772,12,12,33,0,29630,27312
CardCounter,32,0.4386594853381209,0.5613405146618791,16,16,5,0,29635,27312
CardCounter,29,0.4383971291866029,0.5616028708133971,15,17,72,0,29707,27312
CardCounter,34,0.43813508667065154,0.5618649133293485,20,17,5,0,29712,27312
CardCounter,19,0.4378733572281959,0.562126642771804,9,11,32,0,29744,27312
CardCounter,10,0.4376119402985075,0.5623880597014925,5,7,68,0,29812,27312
CardCounter,83,0.4373508353221957,0.5626491646778043,44,45,22,0,29834,27312
Random,13,0.43768634466308887,0.5623136553369111,7,6,0,11,29834,27323
CardCounter,41,0.4374255065554231,0.5625744934445769,23,24,47,0,29881,27323
Random,19,0.4377605717689101,0.56223942823109,11,9,0,9,29881,27332
CardCounter,20,0.4375,0.5625,10,10,31,0,29912,27332
Random,23,0.4378346222486615,0.5621653777513385,13,11,0,21,29912,27353
CardCounter,19,0.43757431629013077,0.5624256837098692,10,10,49,0,29961,27353
CardCounter,20,0.43731431966726086,0.5626856803327391,11,11,29,0,29990,27353
Random,32,0.43764845605700714,0.5623515439429929,16,19,0,13,29990,27366
Random,17,0.4379821958456973,0.5620178041543027,11,8,0,45,29990,27411
CardCounter,13,0.4377224199288256,0.5622775800711743,6,7,20,0,30010,27411
CardCounter,40,0.43746295198577356,0.5625370480142264,21,21,76,0,30086,27411
CardCounter,15,0.4372037914691943,0.5627962085308057,7,8,30,0,30116,27411
Random,13,0.43753700414446417,0.5624629958555358,9,6,0,49,30116,27460
Random,34,0.4378698224852071,0.5621301775147929,18,18,0,20,30116,27480
CardCounter,78,0.43761088113542285,0.5623891188645772,40,42,77,0,30193,27480
CardCounter,31,0.4373522458628842,0.5626477541371159,15,19,118,0,30311,27480
Random,107,0.4376845835794448,0.5623154164205553,61,56,0,27,30311,27507
CardCounter,17,0.4374262101534829,0.5625737898465171,8,9,23,0,30334,27507
Random,67,0.4377581120943953,0.5622418879056047,35,35,0,47,30334,27554
Random,44,0.4380896226415094,0.5619103773584906,23,22,0,20,30334,27574
Random,59,0.4384207424867413,0.5615792575132587,32,32,0,0,30334,27574
CardCounter,21,0.4381625441696113,0.5618374558303887,12,12,56,0,30390,27574
Random,75,0.4384932313125368,0.5615067686874632,41,39,0,6,30390,27580
CardCounter,19,0.43823529411764706,0.5617647058823529,9,11,48,0,30438,27580
CardCounter,30,0.43797766019988243,0.5620223398001176,15,17,10,0,30448,27580
CardCounter,13,0.43772032902467684,0.5622796709753232,7,7,22,0,30470,27580
CardCounter,40,0.4374633000587199,0.5625366999412801,22,23,10,0,30480,27580
CardCounter,19,0.43720657276995306,0.562793427230047,9,10,2,0,30482,27580
CardCounter,22,0.436950146627566,0.5630498533724341,12,11,43,0,30525,27580
Random,12,0.4372801875732708,0.5627198124267292,9,7,0,23,30525,27603
CardCounter,37,0.4370240187463386,0.5629759812536614,21,19,57,0,30582,27603
Random,26,0.4373536299765808,0.5626463700234192,13,14,0,66,30582,27669
CardCounter,40,0.4370977179637215,0.5629022820362786,20,20,5,0,30587,27669
CardCounter,41,0.4368421052631579,0.5631578947368421,20,22,85,0,30672,27669
CardCounter,12,0.43658679135008766,0.5634132086499123,9,7,14,0,30686,27669
Random,124,0.4369158878504673,0.5630841121495327,66,67,0,87,30686,27756
Random,13,0.43724460011675426,0.5627553998832457,7,6,0,42,30686,27798
CardCounter,13,0.4369894982497083,0.5630105017502918,6,7,5,0,30691,27798
CardCounter,34,0.43673469387755104,0.563265306122449,18,18,21,0,30712,27798
CardCounter,29,0.4364801864801865,0.5635198135198135,14,15,25,0,30737,27798
Random,61,0.43680838672102507,0.5631916132789749,34,32,0,21,30737,27819
CardCounter,31,0.43655413271245636,0.5634458672875436,16,17,12,0,30749,27819
Random,47,0.43688190808609656,0.5631180919139034,26,25,0,11,30749,27830
CardCounter,33,0.4366279069767442,0.5633720930232559,17,18,20,0,30769,27830
Random,42,0.43695525857059847,0.5630447414294015,23,24,0,28,30769,27858
CardCounter,27,0.4367015098722416,0.5632984901277585,14,16,7,0,30776,27858
CardCounter,16,0.4364480557167731,0.563551944283227,8,9,49,0,30825,27858
CardCounter,39,0.4361948955916473,0.5638051044083526,21,21,22,0,30847,27858
CardCounter,12,0.43594202898550727,0.5640579710144927,6,7,66,0,30913,27858
CardCounter,113,0.43568945538818077,0.5643105446118193,60,60,59,0,30972,27858
CardCounter,22,0.43543717429067746,0.5645628257093225,12,11,17,0,30989,27858
Random,16,0.4357638888888889,0.5642361111111112,8,10,0,81,30989,27939
Random,39,0.43609022556390975,0.5639097744360902,20,21,0,17,30989,27956
Random,28,0.43641618497109824,0.5635838150289018,15,15,0,2,30989,27958
CardCounter,44,0.43616406701328714,0.5638359329867129,23,23,12,0,31001,27958
CardCounter,53,0.4359122401847575,0.5640877598152425,28,29,22,0,31023,27958
CardCounter,16,0.4356607039815349,0.5643392960184651,8,9,14,0,31037,27958
CardCounter,49,0.4354094579008074,0.5645905420991926,26,27,34,0,31071,27958
Random,19,0.43573487031700286,0.5642651296829971,12,11,0,26,31071,27984
CardCounter,9,0.43548387096774194,0.5645161290322581,4,7,25,0,31096,27984
Random,11,0.43580886586067935,0.5641911341393206,8,5,0,62,31096,28046
CardCounter,33,0.43555811277330264,0.5644418872266973,18,18,35,0,31131,28046
Random,17,0.43588269120184014,0.5641173087981599,11,8,0,54,31131,28100
CardCounter,11,0.435632183908046,0.5643678160919541,5,7,51,0,31182,28100
Random,29,0.43595634692705343,0.5640436530729466,16,14,0,15,31182,28115
Random,20,0.4362801377726751,0.563719862227325,10,11,0,46,31182,28161
CardCounter,32,0.43602983362019504,0.5639701663798049,18,17,11,0,31193,28161
CardCounter,57,0.43577981651376146,0.5642201834862385,28,29,30,0,31223,28161
Random,25,0.4361031518624642,0.5638968481375358,13,14,0,20,31223,28181
CardCounter,37,0.43585337915234823,0.5641466208476518,22,19,17,0,31240,28181
Random,13,0.4361763022323984,0.5638236977676016,9,6,0,15,31240,28196
CardCounter,107,0.43592677345537756,0.5640732265446224,54,58,73,0,31313,28196
Random,27,0.4362492853058891,0.5637507146941109,16,13,0,58,31313,28254
Random,44,0.43657142857142855,0.5634285714285714,25,23,0,47,31313,28301
CardCounter,26,0.43632210165619645,0.5636778983438036,15,14,5,0,31318,28301
CardCounter,15,0.4360730593607306,0.5639269406392694,7,9,32,0,31350,28301
CardCounter,24,0.43582430119794635,0.5641756988020536,13,12,35,0,31385,28301
Random,28,0.4361459521094641,0.563854047890536,16,14,0,43,31385,28344
CardCounter,34,0.4358974358974359,0.5641025641025641,18,17,15,0,31400,28344
CardCounter,17,0.4356492027334852,0.5643507972665148,10,9,50,0,31450,28344
Random,21,0.4359704040978941,0.5640295959021059,12,14,0,32,31450,28376
Random,22,0.43629124004550623,0.5637087599544938,11,11,0,40,31450,28416
CardCounter,18,0.43604320636725413,0.5639567936327459,9,11,7,0,31457,28416
CardCounter,45,0.43579545454545454,0.5642045454545455,24,24,1,0,31458,28416
Random,19,0.43611584327086883,0.5638841567291312,11,11,0,0,31458,28416
CardCounter,69,0.4358683314415437,0.5641316685584563,37,38,17,0,31475,28416
Random,69,0.4361883153715258,0.5638116846284742,35,38,0,20,31475,28436
Random,22,0.4365079365079365,0.5634920634920635,12,11,0,64,31475,28500
Random,33,0.4368271954674221,0.5631728045325779,18,16,0,57,31475,28557
Random,34,0.43714609286523215,0.5628539071347678,18,20,0,40,31475,28597
CardCounter,26,0.43689869835880024,0.5631013016411998,14,13,55,0,31530,28597
Random,14,0.43721719457013575,0.5627828054298643,9,7,0,23,31530,28620
CardCounter,22,0.4369700395703787,0.5630299604296213,13,11,6,0,31536,28620
Random,44,0.43728813559322033,0.5627118644067797,24,22,0,98,31536,28718
CardCounter,74,0.4370412196499153,0.5629587803500847,38,43,49,0,31585,28718
CardCounter,17,0.4367945823927765,0.5632054176072234,12,9,3,0,31588,28718
CardCounter,10,0.4365482233502538,0.5634517766497462,6,7,13,0,31601,28718
CardCounter,37,0.4363021420518602,0.5636978579481398,19,22,25,0,31626,28718
Random,19,0.43661971830985913,0.5633802816901409,13,9,0,51,31626,28769
CardCounter,19,0.4363738738738739,0.5636261261261262,10,11,40,0,31666,28769
Random,31,0.43669105233539673,0.5633089476646033,16,15,0,3,31666,28772
Random,18,0.43700787401574803,0.562992125984252,9,9,0,17,31666,28789
Random,81,0.43732433951658234,0.5626756604834177,43,41,0,92,31666,28881
Random,40,0.43764044943820224,0.5623595505617978,22,22,0,46,31666,28927
CardCounter,46,0.4373947220662549,0.562605277933745,25,23,17,0,31683,28927
Random,46,0.4377104377104377,0.5622895622895623,24,26,0,48,31683,28975
Random,45,0.4380257992148065,0.5619742007851934,25,23,0,34,31683,29009
Random,40,0.4383408071748879,0.5616591928251121,20,21,0,64,31683,29073
Random,75,0.43865546218487395,0.561344537815126,41,38,0,9,31683,29082
Random,36,0.43896976483762595,0.561030235162374,19,21,0,29,31683,29111
CardCounter,24,0.4387241186345831,0.561275881365417,12,13,43,0,31726,29111
Random,14,0.43903803131991054,0.5609619686800895,7,7,0,77,31726,29188
CardCounter,10,0.4387926215762996,0.5612073784237004,6,5,90,0,31816,29188
Random,40,0.43910614525139663,0.5608938547486033,24,22,0,20,31816,29208
CardCounter,10,0.4388609715242881,0.5611390284757118,6,9,4,0,31820,29208
Random,44,0.43917410714285715,0.5608258928571429,25,23,0,15,31820,29223
CardCounter,14,0.4389291689905187,0.5610708310094813,7,7,50,0,31870,29223
CardCounter,27,0.43868450390189523,0.5613154960981048,13,17,23,0,31893,29223
Random,19,0.43899721448467965,0.5610027855153203,10,9,0,93,31893,29316
CardCounter,27,0.43875278396436523,0.5612472160356348,15,14,73,0,31966,29316
CardCounter,14,0.43850862548692265,0.5614913745130774,7,9,20,0,31986,29316
Random,18,0.43882091212458285,0.5611790878754171,9,9,0,40,31986,29356
CardCounter,20,0.4385769872151195,0.5614230127848805,10,12,7,0,31993,29356
Random,32,0.4388888888888889,0.5611111111111111,17,17,0,23,31993,29379
CardCounter,26,0.43864519711271516,0.5613548028872848,13,13,31,0,32024,29379
CardCounter,21,0.4384017758046615,0.5615982241953386,13,11,5,0,32029,29379
Random,51,0.4387132556849695,0.5612867443150305,27,26,0,1,32029,29380
CardCounter,33,0.438470066518847,0.561529933481153,16,17,58,0,32087,29380
CardCounter,64,0.43822714681440444,0.5617728531855956,33,33,105,0,32192,29380
CardCounter,19,0.437984496124031,0.562015503875969,9,11,24,0,32216,29380
Random,19,0.43829551743220807,0.5617044825677919,11,10,0,29,32216,29409
CardCounter,41,0.43805309734513276,0.5619469026548672,23,23,29,0,32245,29409
Random,18,0.43836373687119956,0.5616362631288004,9,9,0,76,32245,29485
CardCounter,33,0.438121546961326,0.561878453038674,19,18,67,0,32312,29485
CardCounter,32,0.43787962451684154,0.5621203754831585,16,17,24,0,32336,29485
Random,18,0.4381898454746137,0.5618101545253863,9,10,0,4,32336,29489
Random,27,0.43849972421400996,0.56150027578599,15,13,0,70,32336,29559
Random,32,0.4388092613009923,0.5611907386990077,17,16,0,9,32336,29568
CardCounter,36,0.4385674931129477,0.5614325068870524,19,19,11,0,32347,29568
CardCounter,21,0.43832599118942733,0.5616740088105727,12,11,23,0,32370,29568
Random,101,0.43863511282333517,0.5613648871766649,56,54,0,9,32370,29577
CardCounter,55,0.4383938393839384,0.5616061606160616,30,28,42,0,32412,29577
Random,49,0.43870258383727323,0.5612974161627268,26,25,0,39,32412,29616
CardCounter,37,0.43846153846153846,0.5615384615384615,21,19,2,0,32414,29616
CardCounter,28,0.4382207578253707,0.5617792421746294,16,14,22,0,32436,29616
Random,44,0.43852908891328213,0.5614709110867179,24,22,0,20,32436,29636
CardCounter,36,0.43828853538123974,0.5617114646187603,19,20,18,0,32454,29636
Random,36,0.43859649122807015,0.5614035087719298,19,19,0,38,32454,29674
Random,51,0.4389041095890411,0.5610958904109589,30,25,0,8,32454,29682
Random,56,0.43921139101861995,0.56078860898138,30,30,0,40,32454,29722
Random,37,0.4395183360700602,0.5604816639299398,20,18,0,89,32454,29811
Random,11,0.43982494529540483,0.5601750547045952,6,6,0,45,32454,29856
CardCounter,112,0.4395844723892838,0.5604155276107162,62,58,34,0,32488,29856
CardCounter,43,0.43934426229508194,0.5606557377049181,24,24,43,0,32531,29856
CardCounter,62,0.4391043145821955,0.5608956854178044,33,34,6,0,32537,29856
Random,32,0.439410480349345,0.5605895196506551,16,16,0,8,32537,29864
CardCounter,52,0.4391707583196945,0.5608292416803055,30,29,6,0,32543,29864
CardCounter,21,0.4389312977099237,0.5610687022900763,10,13,21,0,32564,29864
Random,71,0.43923705722070844,0.5607629427792915,40,37,0,78,32564,29942
Random,60,0.4395424836601307,0.5604575163398693,31,32,0,40,32564,29982
Random,45,0.43984757757212845,0.5601524224278716,24,23,0,41,32564,30023
Random,32,0.4401523394994559,0.559847660500544,18,19,0,36,32564,30059
CardCounter,114,0.4399129961935835,0.5600870038064165,61,62,33,0,32597,30059
Random,48,0.44021739130434784,0.5597826086956522,24,24,0,49,32597,30108
CardCounter,14,0.43997827267789247,0.5600217273221075,7,7,21,0,32618,30108
Random,24,0.44028230184581973,0.5597176981541803,12,13,0,49,32618,30157
Random,61,0.4405860010851872,0.5594139989148128,32,32,0,36,32618,30193
Random,42,0.4408893709327549,0.5591106290672451,23,21,0,115,32618,30308
CardCounter,14,0.44065040650406506,0.5593495934959349,7,7,21,0,32639,30308
CardCounter,81,0.44041170097508126,0.5595882990249187,41,46,38,0,32677,30308
Random,71,0.4407146724417975,0.5592853275582025,38,37,0,12,32677,30320
Random,14,0.44101731601731603,0.558982683982684,8,7,0,73,32677,30393
CardCounter,14,0.44077879935100056,0.5592212006489995,7,7,7,0,32684,30393
CardCounter,97,0.44054054054054054,0.5594594594594594,52,52,30,0,32714,30393
CardCounter,14,0.4403025391680173,0.5596974608319827,7,7,43,0,32757,30393
CardCounter,21,0.4400647948164147,0.5599352051835853,10,11,3,0,32760,30393
CardCounter,16,0.4398273070696168,0.5601726929303832,9,8,122,0,32882,30393
CardCounter,19,0.4395900755124056,0.5604099244875944,9,10,6,0,32888,30393
Random,43,0.4398921832884097,0.5601078167115903,22,21,0,67,32888,30460
Random,78,0.4401939655172414,0.5598060344827587,39,44,0,0,32888,30460
CardCounter,74,0.4399569197630587,0.5600430802369413,44,38,14,0,32902,30460
Random,44,0.4402583423035522,0.5597416576964478,24,26,0,3,32902,30463
Random,107,0.4405594405594406,0.5594405594405595,55,56,0,111,32902,30574
CardCounter,17,0.4403225806451613,0.5596774193548387,8,10,10,0,32912,30574
CardCounter,22,0.4400859752821064,0.5599140247178936,13,12,13,0,32925,30574
Random,14,0.44038668098818473,0.5596133190118152,7,7,0,74,32925,30648
Random,15,0.4406870638754697,0.5593129361245304,8,8,0,12,32925,30660
Random,27,0.4409871244635193,0.5590128755364807,15,14,0,35,32925,30695
Random,17,0.4412868632707775,0.5587131367292225,9,10,0,25,32925,30720
Random,32,0.4415862808145766,0.5584137191854234,16,18,0,21,32925,30741
CardCounter,18,0.4413497589716122,0.5586502410283878,9,11,76,0,33001,30741
CardCounter,43,0.4411134903640257,0.5588865096359743,23,22,22,0,33023,30741
CardCounter,32,0.44087747458533977,0.5591225254146602,17,19,44,0,33067,30741
Random,34,0.4411764705882353,0.5588235294117647,19,18,0,0,33067,30741
Random,79,0.4414751469802245,0.5585248530197755,42,39,0,26,33067,30767
CardCounter,37,0.4412393162393162,0.5587606837606838,19,21,28,0,33095,30767
CardCounter,38,0.4410037373198078,0.5589962626801922,19,20,44,0,33139,30767
Random,36,0.4413020277481323,0.5586979722518677,19,20,0,35,33139,30802
Random,65,0.4416,0.5584,36,36,0,21,33139,30823
Random,58,0.44189765458422176,0.5581023454157783,31,30,0,13,33139,30836
CardCounter,20,0.4416622269579116,0.5583377730420884,12,12,3,0,33142,30836
Random,44,0.44195953141640043,0.5580404685835996,23,22,0,40,33142,30876
Random,33,0.4422565194252262,0.5577434805747739,17,18,0,19,33142,30895
CardCounter,21,0.4420212765957447,0.5579787234042554,13,11,2,0,33144,30895
Random,35,0.44231791600212655,0.5576820839978734,21,19,0,35,33144,30930
Random,22,0.44261424017003187,0.5573857598299681,11,12,0,47,33144,30977
CardCounter,80,0.4423791821561338,0.5576208178438662,42,42,31,0,33175,30977
CardCounter,41,0.4421443736730361,0.557855626326964,20,23,110,0,33285,30977
Random,83,0.4424403183023873,0.5575596816976127,43,42,0,33,33285,31010
CardCounter,25,0.44220572640509015,0.5577942735949099,14,13,15,0,33300,31010
Random,117,0.442501324854266,0.5574986751457339,64,60,0,0,33300,31010
Random,8,0.4427966101694915,0.5572033898305084,7,4,0,55,33300,31065
CardCounter,66,0.44256220222339865,0.5574377977766014,33,38,33,0,33333,31065
CardCounter,13,0.44232804232804235,0.5576719576719577,6,7,34,0,33367,31065
CardCounter,50,0.4420941300898995,0.5579058699101005,28,25,34,0,33401,31065
CardCounter,63,0.4418604651162791,0.5581395348837209,33,34,26,0,33427,31065
Random,11,0.4421553090332805,0.5578446909667195,9,5,0,12,33427,31077
Random,50,0.4424498416050686,0.5575501583949314,27,26,0,1,33427,31078
Random,45,0.44274406332453825,0.5572559366754617,24,23,0,75,33427,31153
CardCounter,21,0.44251054852320676,0.5574894514767933,11,11,69,0,33496,31153
Random,9,0.44280442804428044,0.5571955719557196,7,4,0,35,33496,31188
CardCounter,15,0.44257112750263433,0.5574288724973656,7,8,36,0,33532,31188
Random,15,0.44286466561348076,0.5571353343865192,8,10,0,30,33532,31218
Random,80,0.4431578947368421,0.5568421052631579,43,41,0,24,33532,31242
CardCounter,14,0.44292477643345607,0.5570752235665439,7,7,70,0,33602,31242
CardCounter,53,0.4426919032597266,0.5573080967402734,27,30,34,0,33636,31242
CardCounter,26,0.44245927482921704,0.557540725170783,14,13,2,0,33638,31242
CardCounter,15,0.4422268907563025,0.5577731092436975,10,9,2,0,33640,31242
CardCounter,42,0.441994750656168,0.558005249343832,22,22,4,0,33644,31242
Random,20,0.4422875131164743,0.5577124868835257,10,10,0,54,33644,31296
CardCounter,28,0.4420555846879916,0.5579444153120083,16,14,16,0,33660,31296
CardCounter,19,0.4418238993710692,0.5581761006289309,10,12,27,0,33687,31296
CardCounter,14,0.4415924567836564,0.5584075432163437,7,7,53,0,33740,31296
CardCounter,33,0.44136125654450264,0.5586387434554974,16,17,28,0,33768,31296
CardCounter,54,0.4411302982731554,0.5588697017268446,30,30,8,0,33776,31296
CardCounter,11,0.4408995815899582,0.5591004184100419,6,6,58,0,33834,31296
CardCounter,40,0.4406691061160481,0.559330893883952,21,23,28,0,33862,31296
CardCounter,19,0.44043887147335425,0.5595611285266457,11,10,51,0,33913,31296
CardCounter,38,0.4402088772845953,0.5597911227154047,20,22,10,0,33923,31296
CardCounter,91,0.43997912317327764,0.5600208768267223,49,48,5,0,33928,31296
Random,21,0.44027125717266563,0.5597287428273344,12,12,0,4,33928,31300
CardCounter,31,0.44004171011470283,0.5599582898852972,19,16,22,0,33950,31300
CardCounter,54,0.43981240229286084,0.5601875977071391,29,29,40,0,33990,31300
Random,52,0.4401041666666667,0.5598958333333334,29,26,0,36,33990,31336
CardCounter,26,0.4398750650702759,0.5601249349297241,13,14,37,0,34027,31336
CardCounter,27,0.4396462018730489,0.5603537981269511,13,15,33,0,34060,31336
Random,45,0.43993759750390016,0.5600624024960998,25,23,0,46,34060,31382
Random,56,0.4402286902286902,0.5597713097713097,29,30,0,124,34060,31506
CardCounter,22,0.44,0.56,12,11,41,0,34101,31506
CardCounter,11,0.43977154724818274,0.5602284527518172,5,7,72,0,34173,31506
CardCounter,86,0.4395433316035288,0.5604566683964712,46,44,35,0,34208,31506
CardCounter,75,0.43931535269709543,0.5606846473029046,39,38,45,0,34253,31506
Random,13,0.43960601347848627,0.5603939865215137,10,6,0,20,34253,31526
Random,16,0.4398963730569948,0.5601036269430052,12,8,0,38,34253,31564
CardCounter,28,0.4396685655100984,0.5603314344899016,14,15,77,0,34330,31564
Random,70,0.43995859213250516,0.5600414078674948,36,37,0,40,34330,31604
CardCounter,38,0.43973098810139677,0.5602690118986032,21,19,20,0,34350,31604
CardCounter,13,0.43950361944157185,0.5604963805584281,6,7,44,0,34394,31604
CardCounter,14,0.4392764857881137,0.5607235142118863,7,8,10,0,34404,31604
CardCounter,171,0.4390495867768595,0.5609504132231405,92,92,3,0,34407,31604
Random,65,0.43933918430562724,0.5606608156943728,36,33,0,2,34407,31606
Random,44,0.43962848297213625,0.5603715170278638,23,22,0,29,34407,31635
CardCounter,14,0.4394017534811759,0.5605982465188242,9,7,6,0,34413,31635
Random,56,0.43969072164948453,0.5603092783505155,31,29,0,30,34413,31665
CardCounter,26,0.4394641937145801,0.5605358062854199,13,15,30,0,34443,31665
Random,22,0.43975283213182287,0.5602471678681772,12,11,0,50,34443,31715
CardCounter,18,0.4395265054040144,0.5604734945959856,9,10,96,0,34539,31715
CardCounter,25,0.43930041152263377,0.5606995884773662,12,16,10,0,34549,31715
Random,51,0.43958868894601544,0.5604113110539846,31,28,0,29,34549,31744
CardCounter,25,0.4393627954779034,0.5606372045220966,12,15,107,0,34656,31744
CardCounter,20,0.4391371340523883,0.5608628659476117,11,12,40,0,34696,31744
CardCounter,29,0.438911704312115,0.561088295687885,16,16,14,0,34710,31744
Random,13,0.4391995895330939,0.5608004104669061,8,6,0,10,34710,31754
CardCounter,27,0.438974358974359,0.561025641025641,15,15,18,0,34728,31754
CardCounter,16,0.4387493593029216,0.5612506406970784,8,10,19,0,34747,31754
Random,34,0.4390368852459016,0.5609631147540983,17,17,0,31,34747,31785
Random,61,0.4393241167434716,0.5606758832565284,34,33,0,29,34747,31814
CardCounter,45,0.4390992835209826,0.5609007164790174,22,25,87,0,34834,31814
Random,51,0.439386189258312,0.560613810741688,26,26,0,9,34834,31823
Random,18,0.4396728016359918,0.5603271983640081,9,10,0,7,34834,31830
Random,17,0.4399591211037302,0.5600408788962699,10,8,0,26,34834,31856
CardCounter,15,0.4397344228804903,0.5602655771195098,7,8,18,0,34852,31856
Random,35,0.4400204185809086,0.5599795814190913,20,17,0,1,34852,31857
Random,32,0.4403061224489796,0.5596938775510204,17,19,0,26,34852,31883
Random,21,0.44059153493115755,0.5594084650688425,11,10,0,29,34852,31912
CardCounter,11,0.44036697247706424,0.5596330275229358,6,6,40,0,34892,31912
Random,103,0.44065206316861943,0.5593479368313805,55,55,0,27,34892,31939
Random,26,0.4409368635437882,0.5590631364562119,13,13,0,45,34892,31984
Random,17,0.44122137404580153,0.5587786259541985,9,11,0,23,34892,32007
CardCounter,39,0.4409969481180061,0.559003051881994,19,20,60,0,34952,32007
CardCounter,12,0.4407727503812913,0.5592272496187087,7,9,22,0,34974,32007
Random,16,0.4410569105691057,0.5589430894308943,9,10,0,18,34974,32025
Random,35,0.441340782122905,0.5586592178770949,18,18,0,27,34974,32052
CardCounter,41,0.44111675126903555,0.5588832487309645,21,23,60,0,35034,32052
CardCounter,22,0.4408929477422628,0.5591070522577372,12,12,18,0,35052,32052
Random,14,0.4411764705882353,0.5588235294117647,7,8,0,18,35052,32070
CardCounter,90,0.44095286365940195,0.5590471363405981,50,47,11,0,35063,32070
Random,32,0.4412360688956434,0.5587639311043566,17,16,0,22,35063,32092
Random,9,0.44151898734177214,0.5584810126582278,7,4,0,58,35063,32150
Random,20,0.4418016194331984,0.5581983805668016,10,11,0,2,35063,32152
CardCounter,14,0.44157814871016693,0.5584218512898331,8,7,35,0,35098,32152
CardCounter,133,0.4413549039433772,0.5586450960566228,73,70,20,0,35118,32152
CardCounter,108,0.44113188479029813,0.5588681152097019,56,58,30,0,35148,32152
Random,44,0.4414141414141414,0.5585858585858586,22,23,0,0,35148,32152
Random,43,0.4416961130742049,0.558303886925795,23,23,0,6,35148,32158
Random,64,0.4419778002018164,0.5580221997981837,35,34,0,39,35148,32197
Random,15,0.4422592032274332,0.5577407967725668,8,7,0,20,35148,32217
CardCounter,17,0.4420362903225806,0.5579637096774194,8,9,48,0,35196,32217
CardCounter,16,0.4418136020151133,0.5581863979848867,9,9,9,0,35205,32217
CardCounter,19,0.4415911379657603,0.5584088620342397,9,10,63,0,35268,32217
Random,15,0.44187216909914445,0.5581278309008556,8,7,0,47,35268,32264
Random,24,0.44215291750503016,0.5578470824949698,12,12,0,62,35268,32326
CardCounter,44,0.4419306184012066,0.5580693815987934,23,24,12,0,35280,32326
CardCounter,17,0.44170854271356785,0.5582914572864321,10,9,30,0,35310,32326
CardCounter,28,0.44148669010547464,0.5585133098945254,15,15,20,0,35330,32326
CardCounter,27,0.44126506024096385,0.5587349397590361,15,15,19,0,35349,32326
Random,17,0.44154540893125943,0.5584545910687406,9,8,0,32,35349,32358
Random,30,0.4418254764292879,0.5581745235707122,16,16,0,5,35349,32363
Random,19,0.4421052631578947,0.5578947368421052,11,11,0,84,35349,32447
Random,50,0.4423847695390782,0.5576152304609219,28,27,0,20,35349,32467
CardCounter,24,0.44216324486730096,0.557836755132699,13,12,14,0,35363,32467
Random,24,0.44244244244244246,0.5575575575575575,13,13,0,106,35363,32573
CardCounter,18,0.44222111055527763,0.5577788894447223,9,11,13,0,35376,32573
CardCounter,13,0.442,0.558,6,7,40,0,35416,32573
